where is the constituency of the one who is alongside NER, a hong kong politician, from?	Felix_Chung	
who is the successor of the parent of NER, an Irish politician?	Francis_Russell,_Marquess_of_Tavistock	parents	successor
who is the leader of the administrative region to which NER belongs?	热那亚总督	body	leader
who preceded the parent of NER, an american economist?	富兰克林·德拉诺·罗斯福三世	parents	parents
which draft team does the author of NER, a 1998 single by shaquille o'neal, dj quik, lord tariq and peter gunz, belong to?	The_Way_It's_Goin'_Down	chronology	position
who is before the parent of NER, an indian lawyer, statesman, and writer, first prime minister of india (1889-1964)?	贾瓦哈拉尔·尼赫鲁	children	before
where does the location province of NER, a mine in mongolia, belong to?	Khuut_coal_mine	state/province	seat
who does the origin of NER influence's name?	Aryabhata_(crater)	eponym	region	establishedevent
what is the genre of the author of NER, a song performed by carlos santana?	They_All_Went_to_Mexico	chronology	genre
which title does the parent of NER, an american economist, belong to?	富兰克林·德拉诺·罗斯福三世	parents	title
what is the parent mountain of the client of NER?	Ira_Goldstein	
who did a job before the parent of NER?	Francis_Russell,_Marquess_of_Tavistock	parents	predecessor
what is the type of the people, things and things with the same name as NER?	USS_Mauna_Kea_(AE-22)	shipnamesake	type
what is the profession of the one that is after election of NER?	Italian_general_election,_1992	afterelection	profession
who is the creator of the car that NER is related to?	女超人_(電視劇)	related	teleplay
who is before the commander of NER?	美国南方司令部	commander	awards
who did a job before the one that is after election of NER?	Republic_of_China_presidential_election,_1918	afterelection	predecessor
what is spoken by the name included in the NER?	List_of_awards_and_nominations_received_by_Craig_David	name	language
who married the author of NER, an album by garth brooks?	Christmas_Together	chronology	spouse
what is the nationality of the name included in the NER?	List_of_awards_and_nominations_received_by_Craig_David	name	profession
where is the people, things and things with the same name as NER located?	USNS_John_Lewis_(T-AO-205)	shipnamesake	state
who wrote the singer who performed for NER?	3/8_(album)	
which one is known as the prime minister of the one that is after election of NER, a wahl?	Peruvian_general_election,_1985	afterelection
where is the team that won NER grounded?	1955–56_Hapoel_Haifa_F.C._season	team	other
who rules the commander of NER, a middle ages battle?	莱尼亚诺战役	commander	regent
where is the headquarters of the combatant of NER, a civil war?	刚果共和国内战	combatant	headquarters
what is the title of the eponym of NER?	Haldane_(lunar_crater)	eponym	title
who is the leader of the combatant of NER?	悲痛之夜	combatant	leader
what is the religion of the event happened in NER?	上日耳曼尼亞	event	religion
what is the house of the commander of NER?	白藤江之战_(938年)	commander
where does the one that is after election of NER belong to?	German_federal_election,_1920	afterelection	order
who is the successor of the leader of NER?	Colony_of_Greenland_(1950–53)	leader	successor
which dynasty does the leader of NER belong to?	Spanish_general_election,_1869	leader	before
what is the job of the people, things and things with the same name as NER?	Type_0891A_training_ship	
who starred in the sponsor of NER, a wwe's 2012 night of champions pay-per-views?	Night_of_Champions_(2012)	sponsor	format	owner
which religion does the country that is affected by NER belong to?	2006_Yogyakarta_earthquake	countriesaffected	religion
what is the location of the alma mater of NER?	Phil_Bentley	almamater	location
what is involved in the important events attended by NER?	2010–11_Queens_Park_Rangers_F.C._season	
what does the people, things and things with the same name as NER belong to?	French_ironclad_Alma	shipnamesake
what is the succession of the commander of NER?	莱尼亚诺战役	commander	succession
who published the sponsor of NER?	Armageddon_(2008)	sponsor	developer
what belongs to the parent of NER, a mythical character?	涅莱乌斯	parents	children
where is the author of NER, a live album by milt jackson, born?	The_Milt_Jackson_Big_4	chronology
what is the region of the location province of NER?	Alderley_Edge_Mines	
what causes the people, things and things with the same name as NER?	Greek_destroyer_Pindos	shipnamesake
where is the people, things and things with the same name as NER buried?	French_ship_Charlemagne_(1852)	shipnamesake	burialplace
which party does the parent of NER belong to?	Didit_Hediprasetyo	parents	party
which place is called as the subdivision of the location province of NER?	Khökh-Adar_mine	state/province	subdivisionname
what is on the south of the people, things and things with the same name as NER?	Yongfeng-class_coastal_defense_ship	shipnamesake
which war is included in the era of the people, things and things with the same name as NER?	HMS_Malaya	shipnamesake	commonlanguages
who is the leader of NER?	House_of_Assembly_of_Saint_Vincent_and_the_Grenadines	leader	monarch
who is the regnet of the children of NER, a british politician (1836-1914)?	约瑟夫·张伯伦	children	successor
who is the descendant of the successor of NER?	利奥波德四世_(安哈尔特)	issue	issue
which series does the sponsor of NER, a 2003 world wrestling entertainment pay-per-view event, belong to?	Unforgiven_(2003)	event	promotions	industry
where is the south of the location province of NER, a mine in russia?	Sakhalin_coal_mine	state/province
who appointed NER's record company?	中华人民共和国常驻联合国代表团	label	appointer	predecessor
what is the title of the successor of NER?	克里斯托夫_(石勒苏益格-荷尔斯泰因)	issue
what is the party of the one that is after election of NER, a wahl?	United_States_Senate_election_in_West_Virginia,_2014	afterelection	party
where does the one that is after election of NER get the honorific suffix?	Rangitikei_by-election,_1880	afterelection	placeofdeath
which religion does the one that is after election of NER, a wahl, belong to?	United_States_Senate_election_in_Nebraska,_2002	afterelection	religion
who did a job before NER related events?	Gurjara-Pratihara	event	issue
which war is included in the era of the person whose name is used to name NER?	Philolaus_(crater)	eponym	era
who is the manager of the team that won NER?	1968–69_FDGB-Pokal	team
who directed the singer who performed for NER?	3/8_(album)	
what lies in the west of the county that NER belongs to?	索爾科姆	shirecounty	west
what is the timezong of NER's southern region?	Poboleda	s	n
who is the prime minister of the parent of NER?	Francis_Russell,_Marquess_of_Tavistock	parents	primeminister
what is the royal house of the person and things that shares the same name with NER?	RV_Kronprins_Haakon	shipnamesake	royalhouse
what is the status of the country that is spoken NER, a polynesian language related to tuvaluan?	托克劳语	states	status
where did the one who is alongside NER, a roman emperor, die?	Gordian_I	
what is the predecessor of the combatant of NER?	爱尔兰内战	combatant	headquarters
what is the area that the combatant of NER, a civil war, is located in?	刚果共和国内战	combatant	area
who is the predecessor of the coach of NER?	印度國家足球隊	coach	clubs
what does the division that NER belongs to work for?	2009–10_in_Australian_soccer	division
who is the father of NER-related event related persons?	Gurjara-Pratihara	event	issue
what is the timezong of the northwest of NER?	Torres_de_Segre	nw	timezone
who is the starring role of the person and things that shares the same name with NER, a 1976 car-shaped submarine from the james bond film the spy who loved me?	Wet_Nellie	shipnamesake	studio
who married the client of NER?	Royal_Spring,_Warsaw	client	issue
who is the starring role of the theme of NER, a 2016 ride at universal's islands of adventures?	Skull_Island:_Reign_of_Kong	theme	starring
what is the parts type of the archipelago that NER belongs to?	米洛斯岛	archipelago	type
what is the northeast of the county that NER belongs to?	布傑斯希爾	shirecounty	status
what is the origin of NER's name?	Cori_(lunar_crater)	eponym
what is the instrument that the singer who performed for NER, an album by omarion, plays?	Ollusion	extra	instrument
who leads the people, things and things with the same name as NER?	HMS_Malaya	shipnamesake	titleleader
what is in the east of the county that NER belongs to?	布傑斯希爾	shirecounty	region
what is the party of the leader of NER?	Provisional_People's_Committee_for_North_Korea	leader	party
where is the birthplace of the coach of NER?	哈菲兹哈欣	coach	subdivisiontype	subdivision
what is the location of the person and things that shares the same name with NER?	USS_Tutuila_(ARG-4)	shipnamesake	location
which country uses the singer of NER, a languages of a geographic region?	Languages_of_Papua_New_Guinea	extra	fam
who gave birth to the person and things that shares the same name with NER?	HMS_Hecate_(1871)	shipnamesake	parents
who is the spouse of the leader of NER?	Provisional_People's_Committee_for_North_Korea	leader	spouse
which royal house does the client of NER, a historical building in corleone, italy, belong to?	Royal_Palace_of_Ficuzza	client	house
which dynasty does the client of NER belong to?	Royal_Spring,_Warsaw	client	predecessor	succession
where does the person and things that shares the same name with NER belong to?	USS_Winnemucca_(PC-1145)	shipnamesake	settlementtype
who takes the place of the children of NER, a british politician (1836-1914)?	约瑟夫·张伯伦	children	successor
who does the person and things that shares the same name with NER influence?	MS_Henrik_Ibsen	
what is the currency of the event of NER?	Karelian_Autonomous_Soviet_Socialist_Republic	
which leader party does the location province of NER belong to?	Sieberstollen	state/province
who is the commander of the people, things and things with the same name as NER?	French_brig_Lodi_(1797)	shipnamesake	commander
where is the client of NER located?	Ira_Goldstein	
who is the successor of the car that NER is related to?	Sony_Xperia_Z2a	related	successor
where is the person and things that shares the same name with NER born?	Otto_Hahn_(ship)	shipnamesake	birthplace
what is the language that is commonly used by the combatant of NER?	蒂萨河之战	combatant	commonlanguages
which religion does the successor of NER belong to?	吉增·佩玛	issue	religion
who is the successor of things related to NER?	HTC_Desire_626	related	successor
which region does NER belong to related events?	Archduchy_of_Austria	event
what happened in the era of the event of NER?	Kingdom_of_Galicia_and_Lodomeria	
who is the most important people of the controller of NER?	Brownsea_Castle	controlledby	keypeople
which label does the singer who performed for NER, an album by omarion, belong to?	Ollusion	extra	label
who do the job after the one that is after election of NER?	Brazilian_presidential_election,_1960	afterelection	predecessor	after
where is the person and things that shares the same name with NER buried?	USS_Troup_(1812)	shipnamesake	house
who leads the country that is affected by NER?	1857_Basilicata_earthquake	countriesaffected	leader
what is the country admin division of the person and things that shares the same name with NER?	Vaygach_(1989_icebreaker)	shipnamesake	countryadmindivisions
who is the creator of the children of NER?	蘇珊·梅耶	children	creator
which state does the one that is after election of NER, a wahl, belong to?	United_States_Senate_election_in_West_Virginia,_2014	afterelection	state
what lies in the southeast of the largest city of NER?	马托格罗索州	largestcity	southeast
who takes the place of the coach of NER, a men's national association football team representing india?	印度國家足球隊	coach	clubs
which logo is about NER's record company?	I'm_蕭蕭	music	profession
what is the house of the father of NER?	懷寧公主	father	succession
what is the occupation of the leader of NER?	French_legislative_election,_1827	leader	occupation
where is the people, things and things with the same name as NER educated?	French_aircraft_carrier_Joffre	shipnamesake	education
who is the creator of the author of NER?	It's_a_SpongeBob_Christmas!_Album	chronology	creator
who is the leader of the leader of NER, a british politician (born 1967)?	Michael_Ellis_(British_politician)	leader	leader
which religion does the eponym of NER belong to?	Born_(crater)	eponym	religion
where is the birthplace of the commander of NER?	第二次大马士革农村省攻势	commander	birthplace
which language is used in the people, things and things with the same name as NER?	MF_Tysnes	shipnamesake	language
where is the birthplace of the father of NER?	東伏見慈洽	father	workinstitutions
what is the rank of the people, things and things with the same name as NER?	German_destroyer_Mölders	shipnamesake	rank
who is before the commander of NER, a middle ages battle?	莱尼亚诺战役	commander	before
which dynasty does the father of NER belong to?	中山公主_(北齐)	father	dynasty
which timezone does the person and things that shares the same name with NER belong to?	HMCS_Wetaskiwin	shipnamesake	timezone
where does the parent of NER belong to?	Francis_Russell,_Marquess_of_Tavistock	parents	order
where is the alma mater of the people, things and things with the same name as NER?	USS_Nitze	shipnamesake	title
what is the occupation of the one that is after election of NER?	United_States_Senate_election_in_North_Carolina,_1998	afterelection	occupation
who takes the place of the father of NER?	溧陽公主	father	after
what is the start of the country that is spoken NER?	翁果塔語	states	largestcityname
what is the genre of the name included in the NER?	List_of_awards_and_nominations_received_by_Billy_Ray_Cyrus	name	genre
which title does the administrative area responsible for NER belong to?	热那亚总督	body	titleleader
what is children of the one that is after election of NER, a wahl?	South_Korean_presidential_election,_1978	afterelection	children
whose ancestor is the father of NER, a the king of the goryeo dynasty of korea (955-981),??	高丽景宗	father	father	issue
which title does the bay that NER, an american astronomer, is famous for belong to?	史蒂文·沃格特	knownfor	title
which award is the one who is alongside NER, a japanese general and war criminal, given?	Takashi_Sakai	
what is the event of the event happened in NER, a former country?	加利西亚和洛多梅里亚王国	event	event
what is the name of the person who influenced the origin of NER's name?	Sherrington_(crater)	eponym	influenced
which branch does the person and things that shares the same name with NER, a barku den fransia, belong to?	French_cruiser_Foch	shipnamesake	rank	department
what is the status of the cause of NER?	第一次纽托尼亚战役	result	leader
which language is used in the location province of NER, a silver mine located in the south of argentina in chubut province?	Navidad_mine	state/province	language
who built the people, things and things with the same name as NER?	Osterley_(1780_EIC_ship)	shipnamesake	architect
who is the monarch of the person and things that shares the same name with NER, an unit of the canadian forces naval reserve based in ottawa, ontario?	HMCS_Carleton	shipnamesake	battles
which affiliation does the alma mater of NER belong to?	Ed_Jackson_(Tennessee_politician)	almamater
what is the person and things that shares the same name with NER awarded?	German_cruiser_Blücher	shipnamesake	branch
which title does the commander of NER belong to?	东北1947年秋季战役	commander	title
who created the bay that NER is famous for?	克勞德·加拉蒙	knownfor	creator
who leads the event happened in NER?	上日耳曼尼亞	event	leader
what is the deathpalce of the person whose name is used to name NER?	Lippershey_(crater)	eponym
what is the series of things related to NER, an android smartphone by sony?	Sony_Xperia_Z3+	related	series
what is the government type of NER related events?	Karelian_Autonomous_Soviet_Socialist_Republic	
where is the alma mater of NER located?	Mark_Van_Ameyde	almamater
which museum includes the caption of the country that is spoken NER, a language of the baekje kingdom in ancient korea?	百濟語	states	country
who is the parent of the parent of NER?	富兰克林·德拉诺·罗斯福三世	parents	parents
what it the product of the team that won NER, a french motocross rider?	Thomas_Pagès	team	products
who has an important influence on the client of NER?	Ramsay_Garden	client	influences
which country does the person and things that shares the same name with NER belong to?	USS_Nitze	shipnamesake	title	department
which region does the bay that NER is famous for belong to?	迈尔·阿姆谢尔·罗斯柴尔德	knownfor	region
what is the origin of NER known for's name?	Boltzmann_(crater)	
what is the person and things that shares the same name with NER, a russian floating nuclear power plant.?	Akademik_Lomonosov	
which mountain range does things related to NER belong to?	Axe_(brand)	related	parent
which battle is the people, things and things with the same name as NER involved?	Russian_destroyer_Marshal_Shaposhnikov	shipnamesake	battles
where is the birthplace of the one that is influenced by NER?	伯納德·劉易斯	influenced	birthplace
what is the job of the singer who participated in NER?	Aim_High_(TV_series)	extra	profession
which religion does the people, things and things with the same name as NER belong to?	USRC_James_Madison_(1807)	
which language is commonly used in the person and things that shares the same name with NER?	Mohawk_(1781_ship)	shipnamesake	languages
what started the person and things that shares the same name with NER?	HNoMS_Otra_(1939)	
who is the predecessor of the client of NER?	Royal_Spring,_Warsaw	client	predecessor
what is the nickname of the alma mater of NER?	Paul_Bailey_(politician)	almamater
who is the source of the origin of NER's name?	Penticton_(crater)	eponym	source
who is the consort of the people, things and things with the same name as NER?	HMS_Ariadne_(1816)	shipnamesake	parents
where does the event of NER take place?	Empire_of_China_(1915–16)	
which type does the country that is spoken NER belong to?	晋城话	states	subdivisiontype
which event establishes the country of birth of NER?	伊格尔·茨维塔诺维奇	countryofbirth	label
which school does the artist who sings for NER belong to?	Tokyo_Juliet_(TV_series)	
who created the theme of NER?	Skull_Island:_Reign_of_Kong	theme	artist
which title does the cause of NER, a battle, belong to?	貝德里亞庫姆戰役	result	placeofdeath
who is the female parent of the person and things that shares the same name with NER?	MV_Prins_Harald	shipnamesake
what is the format of the notable work of NER, an american broadcaster and journalist?	Aleks_Krotoski	notableworks	format
what is the legislature of the country of birth of NER?	伊格尔·茨维塔诺维奇	countryofbirth	label
which house does the event of NER, an indian dynasty that ruled much of northern india from the mid-8th century to the 11th century, belong to?	Gurjara-Pratihara	event	issue
what is the work place of the people who influence NER?	亚历山大·里奇	influences	workplaces
who is the predecessor of the leader of NER?	United_Kingdom_general_election,_1886_(Ireland)	leader	honorificprefix
what is the instrument that the name included in the NER, a wikimedia list article, plays?	List_of_awards_and_nominations_received_by_Jessica_Simpson	name	instrument
who is the director of the theme of NER?	Skull_Island:_Reign_of_Kong	theme	director
which label does NER belong to related events?	UEFA_Women's_Euro_2013_Final	event	label
what is the cause of the event involved in NER?	Archduchy_of_Austria	event
when is the author of NER born?	Can_I_Borrow_a_Dollar%3F	chronology	format	owner
which league does the team that won NER belong to?	1923–24_Atromitos_F.C._season	team
who is the spouse of the parent of NER?	Buhe_(politician)	
which team takes part in the author of NER, a 1998 single by shaquille o'neal, dj quik, lord tariq and peter gunz?	The_Way_It's_Goin'_Down	chronology	before
where did the combatant of NER die?	確山戰鬥	combatant	deathplace
who directed the team that won NER?	Red_Bull_RB12	team	director
which title does the client of NER own?	Royal_Spring,_Warsaw	client	title
which language does the singer who performed for NER use?	Boysitter	extra
who makes the law of the cause of NER, a battle of the american civil war?	第一次纽托尼亚战役	result	leader
who is before the father of NER?	清都公主	father
who is the successor of the people, things and things with the same name as NER?	Warren_Hastings_(1802_EIC_ship)	shipnamesake	successor
who honored the children of NER?	安華	children
who is the successor of the one who is alongside NER, a roman emperor (201-251)?	Decius	
what is the occupation of the author of NER?	Lovers_(Cannonball_Adderley_album)	chronology
where does the one that is after election of NER, an election in minnesota, belong to?	United_States_presidential_election_in_Minnesota,_1968	afterelection	format
what is the title of the children of NER?	女節	children	subdivisiontype
who is the predecessor of the people, things and things with the same name as NER?	USS_Charles_F._Hughes_(DD-428)	shipnamesake	after	before
who married the eponym of NER?	Cori_(lunar_crater)	eponym
what is the subdivision name of the people, things and things with the same name as NER?	HMCS_Kamloops	shipnamesake	subdivisionname
who is the chairman of the sponsor of NER?	SummerSlam_(1994)	sponsor	chairman
where is the combatant of NER born?	確山戰鬥	combatant	birthplace
where did the origin of NER study's name?	Nagaoka_(crater)	eponym	almamater
which affiliation does the alma mater of NER belong to?	Frank_Darling_(architect)	almamater	affiliations
who is the spouse of the one that is after election of NER?	German_presidential_election,_1994	afterelection	title	style
what is the author of NER?	Unbreakable_(Janet_Jackson_album)	chronology	profession
what is the branch that the parent of NER, an indonesian socialite, belongs to?	Didit_Hediprasetyo	parents	branch
which timezone does the team that won NER, a volleyball player, belong to?	Liset_Herrera	
which dynasty is the leader of NER, an a mostly dhulbahante state based in the khatumo region which opposed imperialism that existed from the years 1896 until 1921, born?	Dervish_state	leader	placeofbirth
what is the timezong of the people, things and things with the same name as NER?	HMCS_Parry_Sound	
what is the location country of the client of NER?	Warner_elevator_row	
who is issued by NER related events?	Gurjara-Pratihara	event	issue
what is the warrior of the person and things that shares the same name with NER?	SAS_Isandlwana_(F146)	shipnamesake
which is the capital of the location province of NER?	Salinas_Grandes_mine	
who is the successor of the successor of NER?	斐迪南·菲利普_(奧爾良公爵)	issue	successor
which house does the person and things that shares the same name with NER belong to?	HMS_Black_Prince_(81)	shipnamesake	issue	house
what is the electoral district of the sponsor of NER?	Stafford_150	
where does the people, things and things with the same name as NER take place?	French_ship_Rivoli_(1810)	shipnamesake	partof
which party does the people, things and things with the same name as NER belong to?	USRC_Bibb_(1843)	shipnamesake	party
which place is called as the subdivision of the city in the south of NER?	Vall-llobrega	
which national team does NER's coach belong to?	Seattle_Sounders_FC_2	s	headquarters
who is influenced by the name included in the NER?	Empedocles_(volcano)	name	influenced
which title does the nickname of NER belong to?	思希	nickname	title
which team won the coach of NER, an american professional basketball team?	布鲁克林篮网	coach	team
who did a job before the person and things that shares the same name with NER?	USS_Windom_(1896)	shipnamesake	after	after
which religion does the leader of NER believe?	United_States_of_Indonesia	
what is the address of the person whose name is used to name NER	Cori_(lunar_crater)	eponym
which country does the person whose name is used to name NER, a crater on mercury, belong to?	Mendes_Pinto_(crater)	eponym	birthplace
who is the founder of the person and things that shares the same name with NER?	Soviet_cruiser_Komintern	shipnamesake	founder
where did the one that is after election of NER study?	United_States_Senate_election_in_North_Carolina,_1998	afterelection	almamater
which country does the theme of NER belong to?	The_Wizarding_World_of_Harry_Potter_(Universal_Studios_Japan)	theme	country
what is the largest city of the person and things that shares the same name with NER, a brazilian warship?	Brazilian_monitor_Alagoas	shipnamesake	largestcity
what kind of company is the sponsor of NER?	Vodacom_Cup	sponsor	companytype
who is issued by the people, things and things with the same name as NER?	RMS_Queen_Mary_2	
which province does the alma mater of NER belong to?	Amy_Jephta	
what does the status of the people, things and things with the same name as NER belong to?	HMS_Montserrat_(K586)	
what is the map caption of the people, things and things with the same name as NER?	French_ship_Polyphème_(1815)	shipnamesake	subdivisiontype
what is the type of NER's related products?	Kinder_Joy	related	type
which country does the alma mater of NER belong to?	Shin_Chang-jae	almamater
what is the alma mater of the one that is influenced by NER?	阿兰·巴迪欧	influenced	almamater
which label does the author of NER work for?	The_Milt_Jackson_Big_4	chronology
what is the leader title of the location province of NER, a copper mine in papua new guinea (bougainville island)?	Panguna_mine	state/province	leadertitle
what is the region of the person and things that shares the same name with NER?	USS_Platte_(AO-186)	
what is the office of the one that is after election of NER?	Northern_Cyprus_presidential_election,_2015	afterelection	office
which currency is used in the person and things that shares the same name with NER, an a colony-class frigate of the united kingdom that served during world war ii?	HMS_Nyasaland_(K587)	
who makes the law of the location country of NER?	布莱德城堡	locationcountry	leadername
what is the religion of the man who influenced NER?	朱塞佩·加里波底	influences	religion
which country does the one that is after election of NER belong to?	United_States_Senate_election_in_North_Carolina,_1990	afterelection	president
who founded the controller of NER?	Brownsea_Castle	controlledby	founder
who is the director of the person and things that shares the same name with NER?	Wet_Nellie	shipnamesake	studio
which type of government does the person and things that shares the same name with NER belong to?	HMCS_Sherbrooke	
which one is presented before the person and things that shares the same name with NER, a 1976 car-shaped submarine from the james bond film the spy who loved me?	Wet_Nellie	shipnamesake	studio
who gives the honorific suffix of the parent of NER, an Irish politician?	Francis_Russell,_Marquess_of_Tavistock	parents	honorificsuffix
what is the person whose name is used to name NER?	Cavendish_(crater)	
what is the title of the leader of NER, an eleccions generals d'espanya?	Spanish_general_election,_1869	leader	title
who did a job before the author of NER?	The_Way_It's_Goin'_Down	chronology	after
where is the birthplace of the leader of NER?	Classical_Athens	
what is originated from the people, things and things with the same name as NER, an abdiel-class minelayer?	HMS_Apollo_(M01)	shipnamesake	children
who is the spouse of the people, things and things with the same name as NER?	French_ship_Alexandre_(1857)	shipnamesake	succession
who takes the place of the commander of NER, a battle of the american revolutionary war?	長岬之戰	commander	after
what is the constituency of the person and things that shares the same name with NER?	USNS_Harvey_Milk_(T-AO-206)	shipnamesake	constituency
which religion does the administrative area responsible for NER belong to?	热那亚总督	body	religion
who is before the nickname of NER?	思希	nickname	before
who does the people, things and things with the same name as NER, a historical french ship, influence?	French_frigate_Descartes	shipnamesake	almamater
what is the era of the cause of NER?	第一次纽托尼亚战役	result	leader
what is the genre of the theme of NER, an area in universal studios japan?	The_Wizarding_World_of_Harry_Potter_(Universal_Studios_Japan)	theme	genre
who is the predecessor of the car that NER is related to?	HTC_One_X9	related	predecessor
who is the predecessor of the one that is after election of NER?	Italian_general_election,_1874	afterelection	after	predecessor
who is the predecessor of the client of NER, a historical building in corleone, italy?	Royal_Palace_of_Ficuzza	client	before
who is the predecessor of the leader of NER, an eleccions generals d'espanya?/ who is the father of the leader of NER, an eleccions generals d'espanya?	Spanish_general_election,_1869	leader	before
what is spoken by the leader of NER?	Dervish_state	leader	language
what is the club that NER's head coach belongs to?	Seattle_Sounders_FC_2	s	headquarters	subdivisiontype
what is the style of the father of NER, a chinese martial artist and physician?	黃飛鴻	father
what is the title leader of the cause of NER?	第一次纽托尼亚战役	result	leader
which type of subdivision does the people, things and things with the same name as NER, a ship of the royal canadian navy, belong to?	HMCS_Peterborough	shipnamesake	subdivisiontype
which office does the leader of NER, a Spanish politician, belong to?	Miguel_Primo_de_Rivera_y_Sáenz_de_Heredia	leader	title
who is the next the father of NER?	和硕和惠公主	father
who commanded the name included in the NER?	Germanic_Wars	
who is the male parent of the client of NER?	Royal_Spring,_Warsaw	client	issue
who is the successor of the father of NER?	清都公主	father
who is the successor of the parent of NER, an american economist?	富兰克林·德拉诺·罗斯福三世	parents	after
who is the successor of the leader of NER?	Duchy_of_Anhalt	
who is the creator of the notable work of NER?	Sarah_Natochenny	notableworks	creator
where is the constituency of the one that is after election of NER from?	Taiwan_legislative_election,_1995	
who takes the place of the cause of NER, a 1106 battle during the invasion of normandy by henry i?	坦什布赖战役	result	successor
who is the deputy of the combatant of NER?	悲痛之夜	combatant	leader
who takes the place of the war that happened in the era of NER?	聯合尼德蘭主權公國	era
which country does the one that is after election of NER belong to?	Colombian_presidential_election,_1986	afterelection	country
what is the common language of the area of NER related events?	Kingdom_of_Galicia_and_Lodomeria	
what is the leader name of the person and things that shares the same name with NER?	HMS_Montserrat_(K586)	
what is the nationality of the one that is after election of NER?	Civic_Democratic_Party_leadership_election,_1997	afterelection	title
where is the people, things and things with the same name as NER located?	French_battleship_Carnot	shipnamesake	country
which event happened in the person and things that shares the same name with NER?	HMS_Malaya	shipnamesake	commonlanguages
who is the mother of the client of NER?	Royal_Palace_of_Ficuzza	client	mother
what is the type of the archipelago that NER belongs to?	米洛斯岛	archipelago	type
which battle does the controller of NER take part in?	INS_Trata	controlledby	battles
which label does the country that is spoken NER, a language, have?	翁果塔語	states	title
what is the event of the cause of NER?	第一次纽托尼亚战役	result	leader
what is the allegiance of the person and things that shares the same name with NER, a barku, to?	CSS_Stonewall_Jackson	shipnamesake	allegiance
which dynasty does the successor of NER live in?	貝倫加利亞_(卡斯蒂利亞)	issue	house
who is the successor of the cause of NER?	貝德里亞庫姆戰役	result	placeofdeath
what is the type of the bay that NER is famous for?	约翰·彭伯顿	knownfor	type
who is the predecessor of the one who is alongside NER?	Felix_Chung	
who is the predecessor of the children of NER, a british politician (1836-1914)?	约瑟夫·张伯伦	children	predecessor
what is the region of the chief town of NER?	Canton_of_Liévin-Sud	chieftown
which timezone does the city in the south of NER, a municipality in noguera, ponent, lleida province, spain, belong to?	Montgai	s	w
what is the rank of the one that is after election of NER?	Guatemalan_general_election,_2011	afterelection	rank
who did a job before NER-related products+?	Sony_Xperia_Z3	related	before
where is the location province of NER, a bergwerk in senegal, seated?	Falémé_mine	state/province	seattype
where is the capital of the person and things that shares the same name with NER located?	HMS_St._Helena_(K590)	shipnamesake	establishedevent	largestcity
what is the allegiance of the one who is alongside NER to?	Takashi_Sakai	
where did the leader of NER, a state, die?	Government_of_National_Salvation	leader	deathplace
which bay lies in the southwest of the country of birth of NER?	伊格尔·茨维塔诺维奇	countryofbirth	capital	northwest
what is the title of the car that NER, a television series, is related to?	無敵情報員	related	previousshow
which branch does the one that is after election of NER belong to?	Thai_general_election,_1996	afterelection	branch
what is the title of the war that happened in the era of NER?	聯合尼德蘭主權公國	era
who owns the sponsor of NER?	Old_Newton_Cup	sponsor	owner
what includes the event of NER, an isolated human group?	Tanukhids	event	partof
which type does the location province of NER belong to?	Kallazhagar_Temple	state/province	type
who is the producer of the person and things that shares the same name with NER?	Wet_Nellie	shipnamesake	studio
which battle is the one that is after election of NER, a wahl, involved?	South_Korean_presidential_election,_1980	afterelection	battles
which type of post code does the people, things and things with the same name as NER belong to?	USS_Winnemucca_(PC-1145)	shipnamesake	postalcodetype
what is the office of the one who is alongside NER?	Hyon_Yong-chol	alongside	office
where did the people, things and things with the same name as NER die?	French_cruiser_Foch	shipnamesake	rank
who founded the sponsor of NER, a female adopted child?	Adopted_Daughter	sponsor	hqlocationcity	north
what is the origin of the name included in the NER?	List_of_awards_and_nominations_received_by_Bunga_Citra_Lestari	name	occupation
when is the one that is after election of NER born?	Belizean_general_election,_1984	afterelection	placeofbirth
who is earlier than the author of NER?	The_Way_It's_Goin'_Down	chronology	before
who is the mother of the leader of NER?	Albanian_Kingdom_(1928–39)	leader	issue
which place is called as the subdivision of the chief town of NER, a canton of france?	Canton_of_Nemours	chieftown	subdivisionname
who makes the law of the location province of NER?	Pyrkakay_mine	state/province	legislature
what is the title leader of NER related events?	Kingdom_of_Galicia_and_Lodomeria	
what does the leader of NER succeed?	Albanian_Kingdom_(1928–39)	leader	issue
who gives the honorific suffix of the commander of NER?	長岬之戰	commander	honorificprefix
what does the chief town of NER, a canton of france (until march 2015), belong to?	Canton_of_Montreuil	chieftown
who is the predecessor of the successor of NER?	貝倫加利亞_(卡斯蒂利亞)	issue	predecessor
who takes the place of the successor of NER?	烏吉克	issue	after
which timezone does the location province of NER belong to?	Selkirk_mine	state/province	seat
where is the city in the south of NER seated?	Garrigues_(comarca)	s	postalcodetype
who is the most important people of the sponsor of NER?	Telstra_Phonewords_Stakes	
which timezone does the northwest of NER belong to?	Tornabous	nw	timezone
who is the leader of the parliament of seats held by NER?	印度尼西亚斗争派民主党	seats1title	leader
who takes the place of the commander of NER?	莱尼亚诺战役	commander	successor
what is the warrior of the name included in the NER?	Germanic_Wars	
who manufactured things related to NER?	Nokia_E5-00	related	manufacturer
what is the title of the person and things that shares the same name with NER, an ironclad warship of the greek navy?	Greek_ironclad_Vasilefs_Georgios	shipnamesake	title
what is the allegiance of the leader of NER to?	Classical_Athens	
what is the type of the alma mater of NER?	Greg_Gard	almamater	type
who is the incumbent of the leader of NER?	Community_of_Saint_Anselm	leader	incumbent
what is the succession of the successor of NER?	斐迪南·菲利普_(奧爾良公爵)	issue	succession
what is the singer who participated in NER, an album by omarion?	Ollusion	extra	occupation
what does the country admin division of the archipelago that NER belongs to belong to?	新不列颠岛	archipelago	countryadmindivisions
what is the alma mater of the man who influenced NER?	朱塞佩·加里波底	influences	almamater
who is the premier of the commander of NER?	东北1947年秋季战役	commander	premier
who is the coach of the team that won NER, a 18th season for the orlando magic?	2006–07_Orlando_Magic_season	team	coach
which genre does the singer of NER belong to?	I'm_So_Sorry	extra	title
what does the person and things that shares the same name with NER end up in?	HMS_Malaya	shipnamesake	commonlanguages
who is the prime minister of the leader of NER, a parlamento di saint vincent e grenadine?	House_of_Assembly_of_Saint_Vincent_and_the_Grenadines	leader	primeminister
what is the profession of the leader of NER?	French_regional_elections,_2015	leader	profession
where is the stadium of the important event of NER, a season of football team, held?	2010–11_Queens_Park_Rangers_F.C._season	
which instrument does the author of NER play?	Identity_(Zee_album)	chronology	instrument
what is the nationality of the people, things and things with the same name as NER?	Type_0891A_training_ship	
who is the predecessor of the one that is after election of NER?	French_legislative_election,_1893	afterelection	predecessor
which dynasty does the cause of NER live in?	坦什布赖战役	result	successor	house
what lies in the northwest of the county that NER belongs to?	布傑斯希爾	shirecounty	region
who makes the law of the person and things that shares the same name with NER?	HMS_Montserrat_(K586)	
which party does the NER-held parliament belong to?	印度尼西亚斗争派民主党	seats1title	party
what is the person and things that shares the same name with NER known for?	French_submarine_Joule	shipnamesake	field
which office does the person and things that shares the same name with NER belong to?	SMS_Hindenburg	shipnamesake	office
what is the combatant of the event of NER?	Fețele_Albe_Dacian_fortress	event
where did the leader of NER study?	United_Kingdom_general_election,_1886_(Ireland)	leader	title
how to address the commander of NER?	瓦雷澤戰役	commander	honorificprefix
what is the southwest of the location province of NER, a mine in russia?	Sakhalin_coal_mine	state/province
which country does the country that is affected by NER belong to?	1857_Basilicata_earthquake	countriesaffected	country
who is the predecessor of the leader of NER, a british politician (born 1967)?	Michael_Ellis_(British_politician)	leader	before
who is the successor of the client of NER?	Royal_Palace_of_Ficuzza	client	successor
who is the descendant of the commander of NER?	定陶之戰_(東漢)	commander	issue
which genre does the person and things that shares the same name with NER belong to?	MS_Henrik_Ibsen	
who takes the place of the car that NER is related to?	索尼Xperia_T	related	successor
what it the product of the sponsor of NER, a horse race?	Black_Opal_Stakes	sponsor	locations	label
where is the birthplace of the one that is after election of NER, a wahl?	Colombian_presidential_election,_1998	afterelection	birthplace
which place is called as the subdivision of the northwest of NER?	Arbúcies	nw	subdivisiontype
which city does the people, things and things with the same name as NER belong to?	USS_Platte_(AO-186)	
who starred in the works that make NER known?	Khalid_Siddiqui	notableworks	extra
which dynasty is the person whose name is used to name NER born?	Haldane_(lunar_crater)	eponym	workinstitution
what is the title of the father of NER?	永安公主_(唐宪宗)	father	title
who is the predecessor of the children of NER?	约瑟夫·张伯伦	children	predecessor
which program is before NER's famous works?	Hiro_Fujiwara	notableworks	genre
what is connected with the person and things that shares the same name with NER?	USS_Hopi_(AT-71)	shipnamesake	related
what is the name of the one that is after election of NER?	United_Malays_National_Organisation_leadership_election,_2009	afterelection	primeminister
where did the commander of NER, an an offense by mahdist forces against british and egyptian troops, die?	喀土穆围城战	commander	almamater
which award is the person whose name is used to name NER given?	Meitner_(Venusian_crater)	eponym	awards
what is the origin of the author of NER?	Parachilna_(album)	chronology
where does the leader of NER belong to?	United_Kingdom_general_election,_1886_(Ireland)	leader	title
what is the status of the combatant of NER?	嘉義之役	combatant	status
what is the type of the sponsor of NER?	Waterstones_11	sponsor	type
who is the father of the leader of NER?	Yue_(state)	leader
who married the author of NER, a single?	Someone_Put_Your_Hand_Out_(Michael_Jackson_song)	chronology	spouse
what is the postal code type of the country that is spoken NER?	晋城话	states	postalcodetype
where did the one that is after election of NER, a wahl, die?	Haitian_presidential_referendum,_1961	afterelection	deathplace
which dynasty is the person and things that shares the same name with NER born?	USS_Schley_(DD-103)	shipnamesake	placeofbirth
what is the source of information of the combatant of NER?	班戈拉赫戰役	combatant	source
what is the southwest of the location country of NER?	布莱德城堡	locationcountry	southwest
which industry is the team that won NER, an american long-distance runner, from?	Natosha_Rogers	team	industry
which national team does the name included in the NER, a national association football team, belong to?	Brunei_national_under-21_football_team	name	position
which sport does NER's coach play?	2014–15_SC_Freiburg_season	s	clubs
what is the province of the client of NER?	Ludvika_Town_Hall	client	provinceprovince
what is the common language of the country of birth of NER, a congolese footballer?	加布里埃尔·萨库亚尼	countryofbirth	commonlanguages
who is the owner of the team that won NER?	Red_Bull_RB12	team	owner
what is in the charge of the person and things that shares the same name with NER?	USS_Carl_M._Levin	shipnamesake	before
what is the name included in the NER?	List_of_awards_and_nominations_received_by_Billy_Ray_Cyrus	name	occupation
what is the profession of the person and things that shares the same name with NER, an arleigh burke-class destroyer?	USS_Carl_M._Levin	shipnamesake	party
which war is included in the era of the name included in the NER?	Empedocles_(volcano)	name	era
which genre does the sponsor of NER, a 2009 world wrestling entertainment pay-per-view event, belong to?	WWE_Breaking_Point	
where does the one that is after election of NER live?	Peruvian_general_election,_1985	afterelection
what is the subdivision rank of the person and things that shares the same name with NER?	Marsouin_(1788_ship)	shipnamesake	subdivisionranks
who is the leader of the country that is spoken NER, a language of the baekje kingdom in ancient korea?	百濟語	states	country
where is the eponym of NER born?	Hevelius_(crater)	eponym	birthplace
who is the one that is after election of NER?	Romanian_general_election,_1922	afterelection	predecessor
who is the last of the commander of NER?	定陶之戰_(東漢)	commander	regent
what is the canton of the northwest of NER?	Amiens	nw
which language is commonly used in the people, things and things with the same name as NER, a 1915 queen elizabeth-class battleship of the royal navy?	HMS_Malaya	shipnamesake	commonlanguages
who gives the honorific suffix of the people, things and things with the same name as NER?	HMS_Bligh_(K467)	shipnamesake	title
where does the bay that NER is famous for come from?	迈尔·阿姆谢尔·罗斯柴尔德	knownfor	region
what kind of company is NER-related products?	WingNut_Films	related	companytype
where is the people, things and things with the same name as NER?	USS_Tutuila_(ARG-4)	shipnamesake	location
who is the consort of the name included in the NER?	Hades_in_popular_culture	name	consort
what is the type of the origin of NER's name?	Bolsena_Lacus	
who is the founder of NER's record company?	天命_(遊戲)	label	founders
what is the name included in the NER, a wikimedia list article?	List_of_awards_and_nominations_received_by_Craig_David	name	profession
which title does the event happened in NER, a former country, belong to?	加利西亚和洛多梅里亚王国	event	titleleader
where is the archipelago that NER belongs to located?	神仙暗沙	archipelago	location
which event establishes the location country of NER?	布莱德城堡	locationcountry	southwest
who is the descendant of the cause of NER?	坦什布赖战役	result	successor	before
who married the father of NER?	高麗光宗	father	spouse
which country does the person and things that shares the same name with NER, a ship, belong to?	French_battleship_Danton	shipnamesake	nationality
what is the ethnicity of the people, things and things with the same name as NER?	MV_Yulius_Fuchik	shipnamesake
which religion does the father of NER belong to?	益里海雅	father	religion
which religion does the country of birth of NER, an Algerian footballer, belong to?	罗内斯·加瓦维	countryofbirth	officialtext
who is the director of NER's famous works?	Khalid_Siddiqui	notableworks	extra
which industry is the sponsor of NER from?	Telstra_Phonewords_Stakes	
who is the predecessor of the client of NER?/ who is the father of the client of NER?	Royal_Palace_of_Ficuzza	client	before
what is the typical subdivision of the northwest of NER, a municipality in the comarca of osona in catalonia, spain?	Gurb	
what is the province of the people, things and things with the same name as NER?	Italian_cruiser_Vittorio_Veneto	shipnamesake	provinceprovince
what is birth place of the successor of NER?	拉米羅一世_(阿斯圖里亞斯)	issue	birthplace
where does the leader of NER get the honorific suffix?	London_local_elections,_2018	leader	title
who is the next the cause of NER?	坦什布赖战役	result	successor
who is earlier than the person and things that shares the same name with NER?	Cornwallis_(1787_ship)	shipnamesake	honorificprefix
which country does the alma mater of NER belong to?	Edward_McAlexander	almamater	country
which company lies in the east of the largest city of NER?	马托格罗索州	largestcity	east
what does the people, things and things with the same name as NER succeed?	Leopoldus_Primus	shipnamesake	succession
who is the extra of the car that NER is related to?	幸福一家人	related	studio
what is the burial place of the client of NER?	Royal_Spring,_Warsaw	client	title
which religion does the combatant of NER belong to?	悲痛之夜	combatant	commonlanguages
what is the nationality of the leader of NER?	French_National_Convention_election,_1792	leader	nationality
who is the spouse of the one who is alongside NER?	Dong_Biwu	
what is the deathpalce of the person and things that shares the same name with NER?	SAS_President_Kruger_(F150)	shipnamesake	order
who is the father of the people, things and things with the same name as NER?	Maud_(ship)	shipnamesake	father
who does the sponsor of NER work for?	Palm_of_Jerusalem	sponsor	author
which mountain range does the sponsor of NER belong to?	2011_Penrith_Panthers_season	sponsor	parent
who is the parent of the children of NER?	安華	children
where did the eponym of NER die?	Eijkman_(crater)	eponym
which city does the alma mater of NER belong to?	Cleo_Baldon	almamater	city
who is the commander of the controller of NER?	INS_Trata	controlledby	commander
where is the event of NER located?	Kingdom_of_Galicia_and_Lodomeria	
who is the director of the sponsor of NER?	Night_of_Champions_(2012)	sponsor	format
where is the capital of the location of NER located related events?	First_Hungarian_Republic	event	capital
who starred in the singer who performed for NER?	3/8_(album)	
which place is called as the subdivision of the southeast of the south of NER?	New_Harmony,_Utah	
what is the name of the chairman of the incumbent of the title of NER?	Khamtai_Siphandon	
what is in the charge of the successor of the candidate of NER?	Constituency_election_results_in_the_United_Kingdom_general_election,_1923	candidate	title
what is the start of the location of the national team that NER belongs to?	拉德·博格達諾維奇	nationalteam	location
what is the religion of the location of the national team that NER, a hong kong association football player, belongs to?	彭梓鍵	nationalteam	location	postalcodetype
what is the subdivision type of the north of the northeast of NER, a town in garfield county, utah, united states?	Antimony,_Utah	
what is the timezong of the east of the south of NER?	Wales,_Utah	
what is the timezong of the east of the south of NER, a town sanpete county, utah, united states?	Wales,_Utah	
which timezone does the north of the west of NER belong to?	Oude_IJsselstreek	west	south
where is the alma mater of the successor of the candidate of NER?	French_regional_elections,_2010	candidate
what is the deathpalce of the successor of the descendant of NER?	Mary_of_Hungary,_Queen_of_Naples	issue	succession
what is the subdivision name of the northeast of the southeast of NER?	Fillmore,_Utah	
which country does the predecessor of the premier of NER, a taiwanese politician, former president of the republic of china, belong to?	Ma_Ying-jeou	
who is the female parent of the successor of the descendant of NER?	Bonne_of_Bohemia	issue	regent
which type of subdivision does the southeast of the southwest of NER, a city in summit county, utah, united states, belong to?	Kamas,_Utah	
who did a job before the predecessor of the candidate of NER?	Neath_(UK_Parliament_constituency)	candidate	predecessor
what is the timezong of the west of the location of NER?	2013–14_Copa_Catalunya	location	timezone1dst
who do the job after the successor of the children of NER?	Sobekemsaf_II	
which dynasty does the legislature of the state party of NER belong to?	Prehistoric_pile_dwellings_around_Lake_Zurich	stateparty	legislature
who did a job before the first the title of NER?	Duncan_McNabb	title	first
town in Dudgett County, Utah, United States, the location in the south of NER, the location in the southwest, which division belongs to	Manila,_Utah	
what type of person or thing with the same name as NER	USS_Mauna_Kea_(AE-22)	shipnamesake	type
who is affected by the person, thing, or thing with the same name as NER?	French_frigate_Descartes	shipnamesake	almamater
what is the zoning of the location in the south of the city where NER is located?	National_Register_of_Historic_Places_listings_in_Montana	countycounty	seat
what is the area of the location in the northwest of the city where NER is located?	National_Register_of_Historic_Places_listings_in_Minnehaha_County,_South_Dakota	city	southwest
who is the successor of NER's election winner?	Italian_general_election,_1992	afterelection	successor
what is the zoning of the location in the north of NER?	France_at_the_2015_World_Speed_Skating_Championships	location	establishedevent
who is the last of the title of NER?	Zhu_De	
where was the first person with the title of NER born?	Shahabuddin_Ahmed	title	incumbent
A town in Pinnacle County, Utah, USA, what is the area of NER, the location in the southwest, and the location in the north?	Francis,_Utah	
what is the country region of the location in the northern part of the province where NER is located?	List_of_Cultural_Properties_of_the_Philippines_in_Cagayan_Valley	provinceprovince	east
NER, the 1991 edition of the FIFA Women's World Cup, what is the title of the venue leader in the northeast of its host	1991_FIFA_Women's_World_Cup	stadium	northwest
what event is the person or thing with the same name as NER	French_ship_Wagram_(1854)	shipnamesake	partof
what is the occupation of the singer who participated in NER?	That_Winter,_the_Wind_Blows	
what is the religion of the origin of the name NER?	Aryabhata_(crater)	eponym	region	animal
where the person whose name is used to name NER was born	Fabry_(crater)	eponym	birthplace
who is the predecessor of the person, thing, and thing with the same name as the Hamburg escort NER?	Leopoldus_Primus	shipnamesake	predecessor
NER, Wikimedia listing article, what team is the captain of its club location	2009_FIFA_U-17_World_Cup_squads	club	captain	clubs
what time zone does the location in the east of NER belong to?	Huntington,_Utah	
what is the division of the location in the southwest of NER's city?	List_of_closed_railway_stations_in_Ireland	countycounty	northwest	seat
what is the title of NER's election winner	Brazilian_presidential_election,_1969	afterelection	predecessor
what party does NER's namesake belong to?	USRC_Ingham_(1832)	shipnamesake	party
what area does NER's southern region belong to?	Prat_de_Comte	
where is the location of the location in the east, where the NER is held for a season of French football clubs	2009–10_Olympique_de_Marseille_season	team
and NER, a ship, what is the area to which the person or thing with the same name belongs	SMS_Zenta	shipnamesake	timezonedst
what state is NER's alma mater in?	Joanne_Grant	
who led the legislature where NER died	Vasili_Yanchenko	deathplace	legislature	leader
what type of company is the owner of a NER club location?	2009_World_Baseball_Classic_rosters	club	league
who is the current incumbent of the title of NER?	Wen_Jiabao	
French politician (1885-1956) who was the predecessor of the previous generation of NER	Yvon_Delbos	
where is the address of NER related events	Empire_of_China_(1915–16)	
what is the name of the mother of the ruler of the descendants of NER?	Princess_Maria_Pia_of_Bourbon-Two_Sicilies_(1849–1882)	
what is the nickname of NER's alma mater?	Mark_Van_Ameyde	almamater
who leads the legislature where NER is used	Renault_FT	usedby	legislature	leader
what products do NER's sponsors have	Telstra_Phonewords_Stakes	
NER's location what time zone does the city in the west belong to?	2013–14_Gimnàstic_de_Tarragona_season	location	w
which city is the operator of NER's location?	2008–09_Torquay_United_F.C._season	team
what is the origin of the name of NER?	HMCS_Vimy	shipnamesake	result
The name of the location leader of the Eastern location of the NER location for a season of the football team is	2015_Beijing_Guoan_F.C._season	location	northwest
NER, British politician (born 1967) who is its leader	Michael_Ellis_(British_politician)	leader	honorificprefix
A town in Millard County, Utah, United States what is the time zone of the location in the southeast of NER, the location in the northeast?	Meadow,_Utah	
what is the famous work of the person named NER?	Maclaurin_(crater)	eponym	knownfor
NER's election winner who's successor	United_States_Senate_election_in_Vermont,_1980	afterelection	alongside
who is the successor of NER's election winner?	Democratic_Party_(HK)_leadership_election,_2002	afterelection
what time zone is used in the southern region of NER?	Massalcoreig	s	timezone
which district does the city in the west of the birthplace of SS officer NER belong to?	Adolf_Ax	birthplace	establishedevent
where are NER related events held?	UEFA_Euro_1980_Final	event	stadium
where is the birthplace of people, things and things with the same name as NER?	President_El_Hadj_Omar_Bongo_(ship,_1978)	shipnamesake	birthplace
who is the leader of the legislature where the French light tank NER of 1936 was used	Hotchkiss_H35	
NER, the early dynastic confederation of ancient Egypt (c. 3150 AD) whose leader was the last	Thinite_Confederacy	
NER, Wikimedia list article, what are the titles of the leaders of the locations south of the city where they are located	National_Register_of_Historic_Places_listings_in_Snohomish_County,_Washington	city	subdivisiontype
NER's election winner who's successor	German_presidential_election,_2009	afterelection	spouse
what classification level does the person or thing with the same name as NER belong to?	USCGC_Clover_(WLB-292)	shipnamesake	subdivisionranks
what is the zoning of the area to the northwest of NER, a village in the province of Girona, Catalonia, Spain	Arbúcies	nw	subdivisiontype
which film company does NER's related products (works) belong to?	鯊魚_(韓國電視劇)	related
who are the people influenced by the people in NER?	Empedocles_(volcano)	name	influenced
what dynasty does NER's name belong to?	Spanish_frigate_Reina_Sofía	shipnamesake	house
NER, Vancouver Whitecaps football season, what is the zoning of the location west of its location	2005_Vancouver_Whitecaps_FC_season	location	west
what is the division of the administrative center of the father of NER, a mountain range in southeastern Poland	Pogórze_Bukowskie	parent	seat
what is the time zone of the location north of the international football match NER?	2015_International_Champions_Cup	stadium
who is NER's child with the same name	HMS_Apollo_(M01)	shipnamesake	parents	children
Who's the previous election winner for Wall NER?	United_States_Senate_election_in_North_Carolina,_1990	afterelection	before
what party is the election winner for Wall NER?	South_African_general_election,_1977	afterelection	before
where NER's election winner was born	Lithuanian_parliamentary_election,_2000	afterelection	president
NER, a waterfall, what is the name of the leader of its province	Dhua_Kund	state/province	leadername
what is the title of the consort of the ruler of NER	Saliha_Dilaşub_Sultan	regent	issue
Wikimedia listing article NER location what is the title of the location leader in the west	Major_national_historical_and_cultural_sites_(Guangdong)	location	seat	seat
NER's location what time zone does the northern location belong to?	South_Carolina_Highway_151	location	north
In a French state (as of March 2015) which district is the main town of NER	Canton_of_Neuilly-Saint-Front	
what time zone is the location in the southeast of the city where the Wikimedia list article NER is located	National_Register_of_Historic_Places_listings_in_Sanpete_County,_Utah	city	southeast
what is the predecessor of NER's election winner?	United_States_Senate_election_in_North_Carolina,_1990	afterelection	before
what is the zoning of the location in the southern part of the international football match NER?	2015_International_Champions_Cup	stadium
NER, an organization from fricktal, to which dynasty the legislature of its country belongs	Research_Institute_of_Organic_Agriculture	country	legislature
what is the religion of NER's clients?	Egelund_House	client	religion
NER, a municipality in the city of Osona Comaca, Catalonia, Spain, where is its northwest area	Gurb	
what is the common language of people, things and things that have the same name as NER?	French_destroyer_Tonkinois	shipnamesake
who is the leader of NER's successor?	Colony_of_Greenland_(1950–53)	leader	issue
what is the zoning of the location in the southeast of NER, a town in Washington County, Utah, United States?	New_Harmony,_Utah	
who are the generals of the people in NER?	Germanic_Wars	
who is the father of NER's name	USS_John_Rodgers_(DD-574)	shipnamesake	title
town in Box Elder County, Utah, United States, what is the area of NER, the location in the east, and the location in the south?	Howell,_Utah	
what time zone does the administrative center of the birthplace of the Malaysian hockey player NER belong to?	Kuhan_Shanmuganathan	birthplace	legislature
which division does the location in the east of NER's city belong to?	National_Register_of_Historic_Places_listings_in_Box_Elder_County,_Utah	city	east
which state is the NER election winner in?	United_States_Senate_election_in_Vermont,_1980	afterelection	state
where is the location in the west of the city where NER is located?	Canyon_Mountains	city	west
who is the predecessor of NER's election winner?	Romanian_general_election,_1922	afterelection	predecessor
who is the father of NER's client	Egelund_House	client	father
who is the successor of the descendants of NER?	利奥波德四世_(安哈尔特)	issue	issue	successor
The field the person whose name is used to name the NER belongs to	Boltzmann_(crater)	
what common language is used for flag events established by the location of NER?	Colombia_national_football_team_results_(1980–99)	location	establishedevent
NER's location what area is the east location in?	South_Carolina_Highway_151	location	north
what instrument did the creator of NER use	Etta_James_(1973_album)	chronology
The royal family of the person, thing, and thing with the same name as NER	SS_Prinses_Astrid	shipnamesake	succession
what is the famous work of the person named NER?	Harden_(crater)	eponym	field
where did NER's election winner's voters come from?	Election_Committee_(Legislative_Council_constituency)_by-election,_2001	afterelection	district
which dynasty does the legislature where the NER take place belong to?	2007_Davis_Cup_World_Group	venue
A city in Cage County, Utah, United States, where is the location north of NER, which time zone is the location west of?	Logan,_Utah	
what war did the person or thing with the same name as NER participate in?	HMS_Bramham_(L51)	shipnamesake	allegiance
what is the common language spoken in the administrative region to which NER belongs?	热那亚总督	body	commonlanguages
NER, the US college basketball season, which time zone is its home eastern location in	2015–16_Idaho_Vandals_men's_basketball_team	home	east	timezonedst
what is the industry of NER's sponsor?	SummerSlam_(1994)	sponsor	industry
what is the previous generation of the election winner of the convention NER that elects the U.S. senator?	United_States_Senate_election_in_Ohio,_1898	afterelection	battles
NER's election winner whose last term was	Thai_general_election,_1996	afterelection	placeofbirth	establishedevent
what is the name of the alma mater of NER's election winner	Labour_Party_(UK)_deputy_leadership_election,_2015	afterelection	honorificsuffix
in which city is NER's alma mater?	Albert_Camus	
which district does the mayor of NER belong to?	Canton_of_Remiremont	chieftown
what titles do people, things and things with the same name as NER have?	French_ship_Charlemagne_(1852)	shipnamesake	title
A city in Garfield County, Utah, United States, where is the location in the north of NER, in which area is the location in the east?	Escalante,_Utah	
NER, Earl of Limburg and Morse (1545-1589), to which division the birthplace of the previous generation belonged	Adolf_van_Nieuwenaar	before	birthplace	subdivisionname
NER, a football championship season, what is the constituency of the location in the east of its venue	2013–14_Isthmian_League	team	timezonedst
what is the constituency for the location west of a sports cricket match NER?	1993_Women's_Cricket_World_Cup	venue	source	college
which division does the southern part of the NER site belong to?	2012_Toulon_Tournament	stadium
who is the successor of NER's election winner?	Israeli_legislative_election,_1992	afterelection	successor
town in Uinta County, Utah, USA, what is the area of NER, the location east of the location, and the location in the northwest?	Ballard,_Utah	
what dynasty belongs to a person or thing with the same name as NER?	RMS_Queen_Mary_2	
who is the leader of the legislature for the position of NER	Bhutan_national_football_team_results	location	leadername
what is the zoning of the location in the southwest of NER's place of residence?	皮姆·富圖恩	deathplace
in which area is the same name of NER?	HMCS_Amherst	shipnamesake	subdivisionname
who is the emperor of the person or thing related to the result of NER	卡爾馬戰爭	result	leader
what team is the head coach of NER on?	2014–15_SC_Freiburg_season	s	position
A town in Wayne County, Utah, U.S.A. what is the area of NER?	Loa,_Utah	
what is the predecessor of the previous generation of the descendants of NER	Adad-nirari_III	
Wikimedia lists the location of the article NER what region does the location in the east belong to?	List_of_Sigma_Pi_chapters	location	east	timezone
The 38th season in franchise history; what zone does the location in the northeast of the first Super Bowl winner NER belong to	2013_Seattle_Seahawks_season	stadium	legislature
what is the party affiliation of the legislature for the position of the football team for a season NER?	1980–81_Eintracht_Frankfurt_season	location	subdivisiontype
Whose predecessor was the place where the NER label was held?	ATP_World_Tour_Masters_1000	label	city
what is the tenant of the NER's venue named?	2001_Kyoto_Purple_Sanga_season	stadium	tenants
which dynasty does the spouse of a descendant of NER belong to?	Sigebert_III	issue	spouse	house
which president does the NER's election winner serve?	Israeli_legislative_election,_1992	afterelection	president
where is the location in the southeast of NER's venue?	1968–69_Inter-Cities_Fairs_Cup	stadium	imagecaption
where is the district where the election winner of the Wall NER is located?	United_States_Senate_election_in_Wyoming,_2000	afterelection	state
what area is the southern city of NER in?	Massalcoreig	s	timezone
who is the predecessor of NER's election winner?	French_legislative_election,_1914	leader	before
what is the region of the NER location in the west and the location in the northeast?	Pé_de_Plátano	southeast	southwest
what is the zip code of the location in the northeast of NER?	List_of_former_Maryland_state_highways_(200–399)	location	west	postalcodetype
what is the rank of Wallner's election winner?	United_States_Senate_election_in_Wyoming,_2000	afterelection	rank
what is the zoning of the location in the northwest where NER died?	Willis_H._Downs	deathplace	legislature
what awards have people or things with the same name as NER won?	USNS_Lewis_B._Puller_(T-ESB-3)	
what time zone is used in the city where the NER is held?	1996–97_UEFA_Cup	stadium	region
what is the religion of NER's election winner?	Labour_Party_(UK)_deputy_leadership_election,_2015	afterelection	honorificsuffix
who is the successor of NER's election winner?	Nigerien_general_election,_2016	afterelection	before	allegiance
what area does the location in the north of NER belong to?	Hurricane,_Utah	
which empire does NER's father belong to?	益里海雅	father	dynasty
what is NER's famous work of the same name?	Spanish_cruiser_Don_Antonio_de_Ulloa	shipnamesake	knownfor
NER's election winner whose last term was	United_States_Senate_election_in_Ohio,_1898	afterelection	battles
who is the king of NER's father (mother)	Francis_Russell,_Marquess_of_Tavistock	parents	monarch
who is the successor of the successor of the descendants of NER?	Élisabeth_Charlotte_d'Orléans	issue	house
what is the country of NER's election winner?	Manila_local_elections,_2016	afterelection	predecessor
what is the location of NER? what is the location in the north?	2012–13_Leicester_City_F.C._season	
what is the time zone of the location in the NER Northwest and the location in the Southwest	Scofield,_Utah	
where is NER located in the North West	2012_Jiangsu_Sainty_F.C._season	location	before
what is the zip code of the person, thing, thing with the same name as NER	HMCS_Levis_(K400)	shipnamesake	east
what is the time zone of the location in the south of the NER and the location in the southwest	Provo,_Utah	south	timezonedst
in which area is the location south of NER, a municipality in Comaca, Anoia, Catalonia, Spain	Carme,_Barcelona	s	timezone1dst
who is NER's predecessor of the same name	Fortitude_(1780_EIC_ship)	shipnamesake	before
where do voters with the same name as NER come from?	USNS_Harvey_Milk_(T-AO-206)	shipnamesake	almamater
NER, submachine gun, which national system is used to mark events established where it is used	MP_34	
what is the state of the election winner of NER, the convention that elects the U.S. senator?	United_States_Senate_election_in_Ohio,_1898	afterelection	state
Express trains between Brussels, Belgium and Switzerland (formerly Italy). what is the dynasty to which the legislature of NER's place belongs?	Vauban_(train)	locale	legislature
who is the leader of the flag event established by the location of NER	2008_in_American_soccer	location	establishedevent
who is the general of the person or thing with the same name as NER?	Chilean_corvette_Chacabuco_(1815)	shipnamesake	commander
NER, Wikimedia listing article, what time zone is used for its location south of the city	National_Register_of_Historic_Places_listings_in_Larimer_County,_Colorado	city	northwest	timezonedst
what is the title of the location leader in the eastern part of the football game NER?	2015_AFC_Champions_League_Final	city	west
which party does Wallner's election winner belong to?	United_States_Senate_election_in_South_Dakota,_2014	afterelection
who is the successor of the descendants of Queen NER of Sweden?	Josephine_of_Leuchtenberg	
what is the flag event established by the location of the National Team of the Football Players Association NER?	林驍城	countryofbirth
which event determines the establishment of the area to which NER's nationality belongs	羅啻	almamater	headquarters
NER's position is named after whose predecessor	State_highways_serving_Virginia_state_institutions	location	north
what are the titles of the location leaders in the northwest of the NER's location?	2012_Chinese_FA_Cup	team
NER, a municipality in la selva comarca, Catalonia, Spain, to which division its northwest location belongs	Osor,_Girona	nw	subdivisiontype
NER, diplomat and statesman of Imperial Japan (1887-1957), who was the predecessor of his successor's previous generation	Mamoru_Shigemitsu	
awhere is the location of Guangzhou Evergrande Taobao 2015NER in the northeast?	2015_Guangzhou_Evergrande_Taobao_F.C._season	location	east
what is the title of the successor of NER's venue?	Uzbekistan_national_under-23_football_team_results	location	leadertitle
what is the zoning of the location in the southeast of NER's home field?	2014–15_BYU_Cougars_women's_basketball_team	home	northeast
what is the name of NER, the leader of the location of the Northeast location of the football team for a season	2012_Shanghai_Shenxin_F.C._season	location	before
who is the successor of the successor of the descendants of NER?	Louis_the_German	
what is the previous generation of the founding emperor of NER's dynasty	Norodom_Kanviman_Norleak_Tevi	issue	after
NER, a coal mine in Russia, where is it located in the western part of the province	Sakhalin_coal_mine	state/province
who is NER's successor's predecessor's next	青年路易	father	after
what is the religion of the country (city) affected by NER	1857_Basilicata_earthquake	countriesaffected	religion
who is the successor of NER's election winner?	Tunisian_Constituent_Assembly_election,_2011	leader	before
NER, 1880, who was the electoral winner of the New Zealand by-election	Rangitikei_by-election,_1880	afterelection	monarch
who are the producers of NER-related products	Nokia_Lumia_625	related	series
who is NER's candidate for the previous generation of kings?	Eden_(New_Zealand_electorate)	candidate	predecessor
who is NER's namesake loyal to?	Russian_destroyer_Marshal_Shaposhnikov	shipnamesake	allegiance
where does the current incumbent of the title of NER take office?	Ho_Chi_Minh	
which party does the person, thing, or thing with the same name as NER belong to?	USCGC_Duane	shipnamesake	party
NER, a song sung by skrillex, what is the occupation of its creator	Ragga_Bomb	chronology
what time zone is used for the location in the southern part of the NER	2012_AFC_Challenge_Cup_qualification	stadium	round	stadium
what is the previous generation of NER's generals?	莱尼亚诺战役	commander	before
NER, American college basketball season, what is the zoning of the location north of its home	2014–15_Utah_Utes_men's_basketball_team	home	north	subdivisionname
NER, where did the election winner of the New Zealand by-election in 1880 die	Rangitikei_by-election,_1880	afterelection	placeofdeath
NER's election winner who's successor	Persian_legislative_election,_1906	afterelection	children
who is the spouse of the previous generation of the title of NER?	List_of_WTF_with_Marc_Maron_episodes	title
The location of the Wikimedia roster NER The name of the location leader in the east is	Macedonia_national_football_team_results	location	establishedevent
NER, a season of a football team, which league does the tenant of its host play in	2012_F.C._Tokyo_season	stadium	tenants
what is the division of the southern city of NER?	Tortellà	s
who is the successor of the place where NER is held?	2011–12_Lekhwiya_SC_season	stadium	founder	successor
what is the form of the title of the venue of NER?	Football_at_the_1990_Asian_Games_–_Men	stadium	tenants	league
who is the successor of the person, thing, thing with the same name as NER?	USS_Hancock_(1776)	
what is the predecessor of the person or thing concerned with the consequences of a battle in China in 617 AD?	霍邑之战	result	successor
NER, the US college basketball season, what is the time zone of the location north of its home field	2014–15_Utah_State_Aggies_men's_basketball_team	home	subdivisiontype
who is the successor of the descendants of NER's spouse	Ptolemy_X_Alexander_I	
what is the title of NER's election winner	Cape_Verdean_parliamentary_election,_2016	afterelection	title
what is the title of the previous generation of the descendants of the Austrian Duchess NER	Viridis_Visconti	issue	title
which region type does the location in the northwest of the region to which the NER belongs	Phu_Phan_Mountains	region	southwest
what are the titles of NER's generals?	杜尔贝战役	combatant
who is the predecessor of the previous generation where NER was held?	2016_Chinese_FA_Cup	team
what is the predecessor of the successor of NER's venue	2014_FIFA_World_Cup_qualification_–_AFC_Third_Round	
which president does the NER's election winner serve?	Bosnian_general_election,_2014	afterelection	president
who is the predecessor of NER's election winner?	Wisconsin_gubernatorial_election,_1986	afterelection	predecessor
where the person or thing with the same name as NER happened	French_fluyt_Égyptienne_(1812)	shipnamesake	partof
who is NER's predecessor of the same name	Russian_cruiser_Gerzog_Edinburgski	shipnamesake	before
what is the type of product or work related to NER	Sony_Xperia_Z2a	related	type
NER's location what area does the location in the northwest belong to?	List_of_Lambda_Chi_Alpha_chapters	location	northeast
who was the president of NER's previous generation	Pierre_Pflimlin	
where does the source of the NER name belong?	Cézanne_(crater)	eponym	influenced
A battle during the Mongol invasion of Hungary in the 13th century which religion did the participating nations of NER believe in?	蒂萨河之战	place	legislature
NER, a village, what is the division of its southern area	Sant_Esteve_de_la_Sarga	s	n
where are the leaders of NER installed?	London_local_elections,_2018	leader	title
which religion does NER's election winner belong to?	United_States_Senate_election_in_North_Carolina,_1998	afterelection	religion
who is the name used to name the person influenced by the NER?	Donne_(crater)	eponym	influenced
what was the previous generation of the leaders of the NER, a monarchy in northern Portugal (January-February 1919)	Monarchy_of_the_North	leader	before
which party does the legislature where the NER is held belong to?	1974_Davis_Cup_Europe_Zone	venue
who is the leader of the administrative area to which NER belongs?	热那亚总督	body	leader
what is the zoning of a city in Cage County, Utah, United States, NER, location, northeast, location, northeast, location?	Mendon,_Utah	
what is the title of the location leader in the east of where the NER is held?	2012_AFC_Champions_League_knockout_stage	stadium	east	seat
who is the predecessor of the current incumbent of the title of former general secretary of the Lao People's Revolutionary Party NER?	Choummaly_Sayasone	
NER, a television series whose title is the leader of the legislature	Drugs,_Inc.	title	north	west
NER, New Zealand Rugby League football player (1995-), where is his birthplace?	Taane_Milne	birthplace	establishedevent
who is the predecessor of NER's election winner?	Election_Committee_(Legislative_Council_constituency)_by-election,_2001	afterelection	district
what is the dynasty to which a football team's season NER's position is established?	2010–11_C.D._Motagua_season	location	seat
who is the leader of the parliament in which NER holds a seat	印度尼西亚斗争派民主党	seats1title	leader
which religion is the NER event?	上日耳曼尼亞	event	religion
who is NER's father's successor?	清都公主	father
what is the rank of NER's election winner?	Guatemalan_general_election,_2011	afterelection	rank
where was the person named NER born	Haldane_(lunar_crater)	eponym	education
who is the mother of the leader of NER	Albanian_Kingdom_(1928–39)	leader	issue
what is the previous generation of NER's election winner?	Italian_general_election,_1874	afterelection	title
NER, in 1869, what titles were the leaders elected by the Spanish generals	Spanish_general_election,_1869	leader	title
who is the architect of the same name of NER	Osterley_(1780_EIC_ship)	shipnamesake	architect
who leads the administrative area to which NER belongs	热那亚总督	body	leader
A country dominated by Durbar Khant, located in the region of Hatumo, where the leader against the imperialist NER that existed from 1896 to 1921 was born	Dervish_state	leader	placeofbirth
what is the parent class of NER's related products	Axe_(brand)	related	companytype
what is the offshoot of the person or thing with the same name as Francia's House Hotel NER?	French_cruiser_Foch	shipnamesake	rank	department
who is the general who is the actual controller of NER?	INS_Trata	controlledby	commander
what wars happened in the era of named characters named as NER	Empedocles_(volcano)	name	era
who are the children of Wallner's election winner?	South_Korean_presidential_election,_1978	afterelection	children
where is the birthplace of the person whose name is in NER	List_of_awards_and_nominations_received_by_Bunga_Citra_Lestari	name	origin
who is the president of NER's team?	Red_Bull_RB12	team	director
which sea area does NER's name belong to?	USS_Tutuila_(ARG-4)	shipnamesake	archipelago
which dynasty the person or thing related to the consequences of NER belongs to	坦什布赖战役	result	successor	house
what is the honorific prefix for NER generals?	瓦雷澤戰役	commander	honorificprefix
where are the people, things and things with the same name as NER	USS_Tutuila_(ARG-4)	shipnamesake	location
what party does the leader of NER belong to?	Provisional_People's_Committee_for_North_Korea	leader	party
who is the king of NER's election winner	Romanian_general_election,_1922	afterelection	predecessor
what is the title of the leader of the administrative area for which NER is responsible?	热那亚总督	body	titleleader
who is the sponsor of NER starring	Night_of_Champions_(2012)	sponsor	format	owner
who is the publisher of NER's sponsor?	Armageddon_(2008)	sponsor	developer
what time zone is the location south of NER in?	Poboleda	s	n
which NER's client belongs to?	Ira_Goldstein	
where does NER's famous work belong to?	迈尔·阿姆谢尔·罗斯柴尔德	knownfor	region
who is the creator of NER?	It's_a_SpongeBob_Christmas!_Album	chronology	creator
what type of archipelago does NER belong to?	米洛斯岛	archipelago	type
who is the successor of NER's general	長岬之戰	commander	after
what war did the man in charge of NER fight in?	INS_Trata	controlledby	battles
what race is the person, thing, thing with the same name as NER?	MV_Yulius_Fuchik	shipnamesake
And NER, an Arleigh Burke class destroyer, where does the person, thing, thing with the same name belong	USS_Carl_M._Levin	shipnamesake	before
where was the creator of NER born	Can_I_Borrow_a_Dollar%3F	chronology	format	owner
which event determined the birth country of the Croatian footballer NER?	伊格尔·茨维塔诺维奇	countryofbirth	label
what type of NER's famous works belong to?	约翰·彭伯顿	knownfor	type
who is the client of the NER, a historic building in Corleone, Italy?	Royal_Palace_of_Ficuzza	client	issue
what is the name of the place east of the largest city in NER, a federal state in Brazil	马托格罗索州	largestcity	west
which country is NER's customer from?	Warner_elevator_row	
who is the coach of NER's team?	2006–07_Orlando_Magic_season	team	coach
what labels are there for countries that use NER	翁果塔語	states	internationaldomainabbreviation
what is the fame of the person whose name was used to name NER?	Boltzmann_(crater)	
where did the name NER come from?	Eijkman_(crater)	eponym
what school did the singer of the NER song graduate from?	Tokyo_Juliet_(TV_series)	
what is the common language used in the relevant area of NER related events?	Kingdom_of_Galicia_and_Lodomeria	
where did the voters played by NER come from?	Felix_Chung	
what are the descendants of the person or thing with the same name as NER?	RMS_Queen_Mary_2	
what is the religion of the same name of NER?	USRC_James_Madison_(1807)	
what is the name of the place in the southwest of the country where NER is located?	布莱德城堡	locationcountry	southwest
which national team is the person in the national football team NER?	Brunei_national_under-21_football_team	name	nationalteam
where does the leader of NER belong?	United_Kingdom_general_election,_1886_(Ireland)	leader	title
what is the award of the same name of NER?	German_cruiser_Blücher	shipnamesake	awards
what is the headquarters address of the participating countries of the Civil War NER?	刚果共和国内战	combatant	area
who is the successor of the person or thing concerned with the consequences of the Battle of NER in 1106 during the invasion of Normandy by Henry I	坦什布赖战役	result	successor
who is the successor of NER's client?	Royal_Spring,_Warsaw	client	issue
where did NER's namesake graduate from?	French_aircraft_carrier_Joffre	shipnamesake	education
which is the branch of the election winner of the Wall NER?	Thai_general_election,_1996	afterelection	branch
what area does the mayor of NER belong to?	Canton_of_Nemours	chieftown	subdivisiontype
what are the affiliations of NER's alma mater	Ed_Jackson_(Tennessee_politician)	almamater
what are the descendants of NER's descendants?	利奥波德四世_(安哈尔特)	issue	succession
what type of creators are NER	They_All_Went_to_Mexico	chronology	genre
what type of country is NER's participating country?	嘉義之役	combatant	status
where did NER's namesake die?	SAS_President_Kruger_(F150)	shipnamesake	placeofdeath
what is the common language spoken in the country of birth of the Congolese footballer NER?	加布里埃尔·萨库亚尼	countryofbirth	commonlanguages
what is the origin of the person whose name is used to name NER?	Penticton_(crater)	eponym	northeast
who is the director of the same name of NER?	Wet_Nellie	shipnamesake	studio
who is the leader of NER's successor?	United_Kingdom_general_election,_1886_(Ireland)	leader	honorificprefix
1998 single, what is the ex-creator of NER by Shaquille O'Neal, dj Quick, Lord Tariq and Peter Gunz	The_Way_It's_Goin'_Down	chronology	position
what type of school is NER's alma mater?	Greg_Gard	name	sitecityst
what are the countries with the same name participating in NER	SAS_Isandlwana_(F146)	shipnamesake
who is the ruler of the children of the British statesman (1836-1914) NER	约瑟夫·张伯伦	children	successor
which province is the client of NER in?	Ludvika_Town_Hall	client	provinceprovince
who is the successor of NER's related products?	Sony_Xperia_Z3+	related	before
what type of people are in NER	List_of_awards_and_nominations_received_by_Billy_Ray_Cyrus	name	genre
who founded the record company NER belongs to?	天命_(遊戲)	label	founders
what is the predecessor of the leader of NER	Spanish_general_election,_1869	leader	before
who does the information about the participating countries of Middle-earth NER come from?	班戈拉赫戰役	combatant	source
who is the next general of NER?	莱尼亚诺战役	commander	regent
which dynasty did the descendants of NER belong to?	貝倫加利亞_(卡斯蒂利亞)	issue	house
who is the current incumbent of the leader of NER?	Community_of_Saint_Anselm	leader	incumbent
who is the author of the singer who participated in NER	3/8_(album)	
who is the Prime Minister of Irish politician NER's father and mother	Francis_Russell,_Marquess_of_Tavistock	parents	honorificprefix
who is the successor of the general of the medieval war NER?	莱尼亚诺战役	commander	successor
who is the predecessor of NER's parents?	Francis_Russell,_Marquess_of_Tavistock	parents	predecessor
who is the president of NER's sponsor	Old_Newton_Cup	sponsor	founder
NER, a fief of the Holy Roman Empire, what caused the events associated with it	Archduchy_of_Austria	event
2013 UEFA Women's Euro 2013 Final Match NER Related Events Tag What	UEFA_Women's_Euro_2013_Final	event	label
what time zone does the volleyball player NER's team use?	Liset_Herrera	
where NER's election winner takes office	Northern_Cyprus_presidential_election,_2015	afterelection	primeminister
who created the work that made American voice actor NER known?	Sarah_Natochenny	notableworks	creator
who is the founder of the actual controller of NER?	Brownsea_Castle	controlledby	founder
what is the language of the people in NER	List_of_awards_and_nominations_received_by_Craig_David	name	language
what is the profession of the singer who performed for omarion's album NER	Ollusion	extra	occupation
who legislates in the country where NER is located?	布莱德城堡	locationcountry	southwest
what is the religion of Wallner's election winner?	United_States_Senate_election_in_Nebraska,_2002	afterelection	religion
where was the creator of NER born	The_Milt_Jackson_Big_4	chronology
where are the descendants of NER buried	拉米羅一世_(阿斯圖里亞斯)	issue	burialplace
which institution does NER's alma mater belong to?	Frank_Darling_(architect)	almamater	affiliations
what is the legislature of NER's country of birth	伊格尔·茨维塔诺维奇	countryofbirth	currency
what is the identity of NER's namesake	HMS_Montserrat_(K586)	
In a French state (as of March 2015) which district is the main town of NER	Canton_of_Montreuil	chieftown
where are NER's customers located?	Ira_Goldstein	
what is the name of the election winner for NER	United_Malays_National_Organisation_leadership_election,_2009	afterelection	primeminister
what war happened in the era of NER's events	Kingdom_of_Galicia_and_Lodomeria	
who is NER's father next?	和硕和惠公主	father
who are the participating teams of the creators of NER?	The_Way_It's_Goin'_Down	chronology	team
where is the address of NER's namesake	French_ship_Rivoli_(1810)	shipnamesake	place
NER, the first prime minister of India (1889-1964), whose parents were his successors	贾瓦哈拉尔·尼赫鲁	parents	predecessor
what is the title of the NER, a former national, and its relevant event leader	Kingdom_of_Galicia_and_Lodomeria	
what is the alma mater of someone affected by NER	阿兰·巴迪欧	influenced	almamater
NER, a mine in Russia, what is the legislature of its province	Pyrkakay_mine	state/province	legislature
who did NER's clients influence	Ramsay_Garden	client	influences	field
which sponsor of NER belongs to?	2011_Penrith_Panthers_season	sponsor	parent
where is the birthplace of the coach of the Malaysian badminton player NER	哈菲兹哈欣	coach	subdivisiontype	subdivision
who was influenced by the person whose name was used to name NER?	Aryabhata_(crater)	eponym	region	establishedevent
who leads the countries and regions affected by NER	1857_Basilicata_earthquake	countriesaffected	leader
what type of country is the country using NER	托克劳语	states	status
what is the name of the alma mater of the person named NER?	Nagaoka_(crater)	eponym	almamater
what is the ex of the client of NER, a historic building in Corleone, Italy	Royal_Palace_of_Ficuzza	client	mother
who has appeared on NER's related products (works)	幸福一家人	related	studio
To whom do NER's sponsors pledge their allegiance	Palm_of_Jerusalem	sponsor	allegiance
what is the honorific suffix of NER's generals?	長岬之戰	commander	rank
what is the industry of NER's sponsor?	Telstra_Phonewords_Stakes	
what religion is the country of birth of the Algerian footballer NER?	罗内斯·加瓦维	countryofbirth	officialtext
To whom did the leader of an ancient Greek city-state NER owe allegiance	Classical_Athens	
who led the participating countries of the NER	悲痛之夜	combatant	leader
which is the branch of NER's parent (mother)	Didit_Hediprasetyo	parents	branch
who are the parents of the American economist NER's parents?	富兰克林·德拉诺·罗斯福三世	parents	parents
what region does NER's province belong to in the country?	Alderley_Edge_Mines	
what religion does NER's father belong to?	益里海雅	father	religion
who is NER's father and mother's spouse	Buhe_(politician)	
what country does NER's name belong to?	French_battleship_Carnot	shipnamesake	country	legislature
what is NER's eponymous legislature	Leopoldus_Primus	shipnamesake	issue
what is the part of the archipelago that NER belongs to?	米洛斯岛	archipelago	partstype
which event determines the formation of a country using NER?	翁果塔語	states	largestcityname
where is the birthplace of NER's election winner	Belizean_general_election,_1984	afterelection	before
where is the person or thing with the same name as NER?	HMS_Bligh_(K467)	shipnamesake	title	residence
what time zone is used in the province where NER is located?	Selkirk_mine	state/province	seat
who is the spouse of the election winner who elected NER?	German_presidential_election,_1994	afterelection	title
what is the company type of NER's sponsor?	Vodacom_Cup	sponsor	companytype
what is the next generation of NER's parents	涅莱乌斯	parents	children
what wars were there in the era of people who were named NER	Philolaus_(crater)	eponym	era
where did the person named NER die	Lippershey_(crater)	eponym
what language is used by people, things and things with the same name as NER	Mohawk_(1781_ship)	shipnamesake	languages
what type of products are related to NER?	Kinder_Joy	related	type
The fuse created by people, things, and things with the same name as NER	HNoMS_Otra_(1939)	
who are the descendants of NER's generals?	定陶之戰_(東漢)	commander	issue
who are NER's parents before?	富兰克林·德拉诺·罗斯福三世	parents	parents
what is the last work of a person or thing with the same name as NER?	Wet_Nellie	shipnamesake	studio
what is the country of the subject of NER?	The_Wizarding_World_of_Harry_Potter_(Universal_Studios_Japan)	theme	country
what is the name of the country's prime minister of walner's election winner	Peruvian_general_election,_1985	afterelection
who is the ruler of the generals of the medieval war NER	莱尼亚诺战役	commander	regent
what is the religion of the person whose name was used to name the lunar crater NER?	Born_(crater)	eponym	religion
what is the political type of person or thing about the outcome of a battle NER in the American Civil War?	第一次纽托尼亚战役	result	leader
who are the successors of NER's parents?	富兰克林·德拉诺·罗斯福三世	parents	parents
who did NER's namesake influence?	French_frigate_Descartes	shipnamesake	almamater
which president does Wallner's election winner serve?	United_States_Senate_election_in_North_Carolina,_1990	afterelection	president
who is the leader of the person or thing with the same name as the 1915 Royal Navy Queen Elizabeth class warship NER	HMS_Malaya	shipnamesake	titleleader
NER's election winner whose last term was	Brazilian_presidential_election,_1960	afterelection	timezone1dst
what is the country of the country (city) affected by NER?	1857_Basilicata_earthquake	countriesaffected	country
who is the leader of NER's event	上日耳曼尼亞	era
where is the southern part of the person or thing with the same name as NER	Yongfeng-class_coastal_defense_ship	shipnamesake
where was NER's father's birthplace	東伏見慈洽	father	workinstitutions
where did NER play die	Gordian_I	
what is the country area to which the person, thing, and thing with the same name as NER belong?	USS_Platte_(AO-186)	
what are the labels of singers who participated in NER?	Ollusion	extra	label
who did the origin of the NER name affect?	Sherrington_(crater)	eponym	influences
Who's next show for NER's writing	Hiro_Fujiwara	notableworks	genre
what is the name of the prime minister of the country of the leader of NER?	House_of_Assembly_of_Saint_Vincent_and_the_Grenadines	leader	primeminister
what type of company is NER related to	WingNut_Films	related	companytype
which empire does NER's father belong to?	中山公主_(北齐)	father	dynasty
who starred in the theme of the 2016 Universal's Islands of Adventure NER	Skull_Island:_Reign_of_Kong	theme	starring
NER, a warship, which country is it named after	French_battleship_Danton	shipnamesake	birthplace
in which area is the election winner of the NER election in Minnesota?	United_States_presidential_election_in_Minnesota,_1968	afterelection	format
which dynasty does NER-related events belong to?	Gurjara-Pratihara	event	issue
what is the previous generation of the children of the British statesman (1836-1914) NER	约瑟夫·张伯伦	children	nationality
what does the creator of NER do?	Lovers_(Cannonball_Adderley_album)	chronology
where is the capital (or provincial capital) of the location involved in the NER-related incident	First_Hungarian_Republic	event	capital
what era is the person or thing related to the consequences of NER?	第一次纽托尼亚战役	result	leader
who are the descendants of NER's clients?	Royal_Palace_of_Ficuzza	client	issue
where is NER's namesake buried	USS_Troup_(1812)	shipnamesake	house
And NER, a car-shaped submarine from the 1976 James Bond film The Spy who Loved Me, it was made by the person or thing with the same name	Wet_Nellie	shipnamesake	studio
who are the descendants of NER's father	高丽景宗	father	father	issue
what region does the mayor of NER belong to in the country?	Canton_of_Liévin-Sud	chieftown
what titles do the related products (works) of the TV series NER have	無敵情報員	related	previousshow
what is the administrative region of the archipelago where NER is located?	新不列颠岛	archipelago	countryadmindivisions	seat
what is the name of the leader of a person, thing, or thing with the same name as NER?	HMS_Montserrat_(K586)	
which country is the leader of NER from?	French_National_Convention_election,_1792	leader	birthplace
where did the creators of NER originate from?	Parachilna_(album)	chronology
NER, the fief of the Holy Roman Empire, which region is the event involved in	Archduchy_of_Austria	event
what is the name of the place in the southwest of the country where the Croatian footballer NER was born?	伊格尔·茨维塔诺维奇	countryofbirth	leadername
NER, a female adopted child, who founded its sponsor	Adopted_Daughter	sponsor	hqlocationcity	north
who is the successor of the leader of NER?	Michael_Ellis_(British_politician)	leader	successor
The consequences of a battle in the American Civil War NER related to whom or who legislated	第一次纽托尼亚战役	result	leader
where did Wallner's election winners live?	Peruvian_general_election,_1985	afterelection
what is the nationality of the person whose name is used to name the NER?	Mendes_Pinto_(crater)	eponym	nationality
what is the title of the person, thing, thing with the same name as NER?	Greek_ironclad_Vasilefs_Georgios	shipnamesake	title
who is the successor of Irish politician NER's father (mother)	Francis_Russell,_Marquess_of_Tavistock	parents	successor
what is the area to which the site belongs to the south of NER, a village in the province of Girona, Catalonia, Spain	Vall-llobrega	
what is the title of the person or thing related to the consequences of fighting NER?	貝德里亞庫姆戰役	result	placeofdeath
where is NER's team	1955–56_Hapoel_Haifa_F.C._season	team	other
Whose name is NER's predecessor?	Warren_Hastings_(1802_EIC_ship)	shipnamesake	monarch
who is the father of NER's client	Royal_Spring,_Warsaw	client	issue
who is the spouse of the person named NER?	Cori_(lunar_crater)	eponym
who is the singer who participated in NER's work?	3/8_(album)	
where do the leaders of NER work?	London_local_elections,_2018	leader	title
what titles are people whose names are used to name NERs	Haldane_(lunar_crater)	eponym	title
where is the archipelago of NER?	神仙暗沙	archipelago	location
which teams are NER's coaches participating in?	布鲁克林篮网	division
what is the previous generation of the coach of the men's National Football Association football team NER representing India?	印度國家足球隊	coach	clubs
what is the rank of the person or thing with the same name as NER?	German_destroyer_Mölders	shipnamesake	rank
who is NER's team that directed the work?	Red_Bull_RB12	team	director
who is the leader of the NER to legislate?	Albanian_Kingdom_(1928–39)	leader	issue
WHAT PRODUCTS FROM THE TEAM OF FRENCH MOTOCROSS NER NER	Thomas_Pagès	team	parent
which event determines the establishment of the country in which NER is located?	布莱德城堡	locationcountry	southwest
what is the nationality of the person whose name is in NER?	List_of_awards_and_nominations_received_by_Craig_David	name	nationality
where is the address of the event involved in NER	Empire_of_China_(1915–16)	
where is the capital (or provincial capital) of the person, thing, and thing with the same name as the Colony-class frigate NER	HMS_St._Helena_(K590)	shipnamesake	establishedevent
what is the common language of the 1915 Royal Navy Queen Elizabeth class battleship NER of the same name	HMS_Malaya	shipnamesake	commonlanguages
who has the name in NER influenced by?	Empedocles_(volcano)	name	influenced
where are the major events of the NER held?	2010–11_Queens_Park_Rangers_F.C._season	
what is the representative of the country that uses NER, a language of the ancient Korean Baekje Kingdom	百濟語	states	country
what is the occupation of the same name of NER?	Type_0891A_training_ship	
what is the religion of the leaders of NER?	United_States_of_Indonesia	
what is the type of the same name of NER	USS_Mauna_Kea_(AE-22)	shipnamesake	type
where are people, things and things with the same name as NER buried?	French_ship_Charlemagne_(1852)	shipnamesake	burialplace
Whose predecessor did NER play	Decius	
who is the star of NER's famous work?	Khalid_Siddiqui	notableworks	extra
where are the birthplaces of those affected by NER	伯納德·劉易斯	influenced	birthplace
what city is in the southwest of NER's province	Sakhalin_coal_mine	state/province
who is the artist who posted the theme of NER	Skull_Island:_Reign_of_Kong	theme	artist
who created the products or works related to NER	女超人_(電視劇)	related	teleplay
what do the creators of NER do?	Unbreakable_(Janet_Jackson_album)	chronology	profession
what are the types of sponsors for NER	WWE_Breaking_Point	
with a floating nuclear power plant in Russia. NER what field does the person, thing, and thing with the same name belong to?	Akademik_Lomonosov	
where is the southern part of the province where NER is located?	Sakhalin_coal_mine	state/province
what religion do the descendants of NER believe in?	吉增·佩玛	issue	religion
what dynasty does NER's client belong to?	Royal_Spring,_Warsaw	client	issue
what caused the name of the warship NER during World War II	Greek_destroyer_Pindos	shipnamesake
in which province is NER's alma mater?	Amy_Jephta	
in which state is NER's alma mater?	Mark_Van_Ameyde	almamater
what dynasty did NER's father belong to?	懷寧公主	father	succession
what is the type of person whose name is used to name the NER	Bolsena_Lacus	
what tag does Brunei football player NER's national team place on	夏蘭尚·賽義德	nationalteam	location	subdivisiontype
what area does the location in the southeast of NER's home ground belong to?	2015–16_Kentucky_Wildcats_men's_basketball_team	home	establishedevent
Taiwanese politician, for which president did the predecessor of the former president of the Republic of China NER's provincial premier serve	Ma_Ying-jeou	
which dynasty belongs to the legislature of the NER's home during the college basketball season?	2015–16_Iona_Gaels_men's_basketball_team	home	legislature
where is the place of death of the successor of the descendants of NER?	Mary_of_Hungary,_Queen_of_Naples	issue	after
what area does the location in the southeast of NER's venue belong to?	2013_Rugby_League_World_Cup	stadium	southeast
NER, a football championship season, which time zone the location northeast of its location belongs to	2015_NCAA_Division_I_Men's_Soccer_Championship	location	east
what is the previous generation of the previous generation represented by NER?	Boston	
who is the father of the ruler of the descendants of NER	Albert_I_of_Belgium	
what is the type of successor to the creator of NER	Grammy_Nominees	music	genre
what is the area of the location in the south of NER's headquarters address?	Scouting_in_Colorado	headquarters
what are the titles of the previous generation leaders of the position of the NER of a football team in a season?	2015_Beijing_Guoan_F.C._season	location	east
what is the name of the leader of the administrative center where NER is located?	NZR_P_class_(1885)	locale
what is the time zone of the location in the south of NER, a town in Sampitt County, Utah, United States?	Wales,_Utah	
what are the last descendants of the descendants of NER, the Dukes of Parma and Piacenza from 1854 to 1859	Robert_I,_Duke_of_Parma	
what time zone does the location in the southern part of NER's venue belong to?	2003_IWCC_Trophy	venue	northeast
A town in Millard County, Utah, United States, the location in the southeast of NER, the location in the north, and which time zone does the location belong to?	Holden,_Utah	
NER, a sporting event, which district is the city in the west of the city where it is located	2001_Women's_Hockey_World_Cup_Qualifier	city	w
who is the first king of the title of NER?	Fernándo_Norzagaray_y_Escudero	title	first
what time zone does the location in the north of NER belong to?	Uintah,_Utah	
what is the provincial capital of the location in the west of the NER's venue?	Lincoln_County_War	place	legislature	leader
what is the previous generation of the successor of NER's venue	Thailand_national_football_team_non-international_results	stadium	after
do you know who was hit by The name of the ship of NER, a historic French ship?	French_frigate_Descartes	shipnamesake	almamater
who is the customer of the NER label	中华人民共和国常驻联合国代表团	label	appointer	predecessor
what is the title of The NER Related Thing	無敵情報員	related	previousshow
who was the NER leader before	Spanish_general_election,_1869	leader	before	issue
what is the dynasty of The father of NER	中山公主_(北齐)	father	dynasty
do you know what the agency headed by The head of NER is	United_Kingdom_general_election,_1886_(Ireland)	leader	honorificprefix
what is the successor to The winner of NER, a 1106 battle during the invasion of normandy by henry i?	坦什布赖战役	result	successor	house
what is the race of NER's ship name	MV_Yulius_Fuchik	shipnamesake
what religion does NER's descendant believe in?	吉增·佩玛	issue	religion
do you know what is the agency headed by NER's ship name	USS_Carl_M._Levin	shipnamesake	party
who is the wife of NER Timeline, an album by garth brooks?	Christmas_Together	chronology	spouse
what dynasty belongs to Events in NER, an indian dynasty that ruled much of northern india from the mid-8th century to the 11th century?	Gurjara-Pratihara	event	issue
who is the predecessor of The Children of the NER, a British politician (1836-1914)?	约瑟夫·张伯伦	children	predecessor
do you know who is next to The winner of NER, a battle?	貝德里亞庫姆戰役	result	placeofdeath
do you know what is the organizational model of the municipal management of the events in NER, a geographical object, Bavarian?	Karelian_Autonomous_Soviet_Socialist_Republic	
do you know what awards Next to NER has won	Takashi_Sakai	
do you know what is the house of The winner of NER	坦什布赖战役	result	successor
do you know what is the famous work of The name of the ship of NER	French_submarine_Joule	shipnamesake	field
what is the battle of Election after NER, a wahl?	South_Korean_presidential_election,_1980	afterelection	battles
do you know what was the last show of The notable works of NER, a japanese manga artist?	Hiro_Fujiwara	notableworks	genre
what is the education of NER's ship name?	French_aircraft_carrier_Joffre	shipnamesake	education
do you know what happened in NER's ship's name, a 1915 queen elizabeth-class battleship of the royal navy?	HMS_Malaya	shipnamesake	titleleader
what is the type of manager of NER	Waterstones_11	sponsor	type
who are the generals participating in the NER name	Germanic_Wars	
do you know what is the estate of NER's ship name	Leopoldus_Primus	shipnamesake	succession
do you know who is the partner of NER's ship name	HMS_Ariadne_(1816)	shipnamesake	consort
do you know where is the birthplace of The leader of NER, a city-state in ancient Greece?	Classical_Athens	
where is the death place of NER's ship name	SAS_President_Kruger_(F150)	shipnamesake	placeofdeath
do you know what is the nationality of the head of NER	French_National_Convention_election,_1792	leader	deathplace
do you know what timezone the province where NER is located in, a bergwerk in botswana?	Selkirk_mine	state/province	subdivisiontype
do you know who is the leader of Election after NER	Romanian_general_election,_1922	afterelection	predecessor
who are the founders of Le label de NER	天命_(遊戲)	label	founders
what are the countries of people, things and things with the same name as participating NER	SAS_Isandlwana_(F146)	shipnamesake
To whom responsible for NER is loyal	Palm_of_Jerusalem	sponsor	allegiance
do you know what is the type of The sea around the NER	米洛斯岛	archipelago	type
what is the organization run by The Parents of NER	Francis_Russell,_Marquess_of_Tavistock	parents	order
What's before The NER Coach	印度國家足球隊	coach	clubs
what eponymous domain of NER belongs to	Cavendish_(crater)	
do you know who is the wife of Election after NER	German_presidential_election,_1994	afterelection	title	style
do you know who are the descendants of Client of NER, a historic building in corleone, italy?	Royal_Palace_of_Ficuzza	client	issue
do you know what time zone is using NER ship name	HMCS_Parry_Sound	
do you know who is the founder of the The name of the ship of NER, a russian cruiser?	Soviet_cruiser_Komintern	shipnamesake	ideology
in which country is the The name of the ship of NER	French_battleship_Carnot	shipnamesake	country
what is related to NER's ship name	USS_Hopi_(AT-71)	shipnamesake	related
do you know what kind of NER ship name	MS_Henrik_Ibsen	
who is the heir of Next to NER, a Roman emperor (201-251)?	Decius	
who is the heir to NER's parents, an Irish politician?	Francis_Russell,_Marquess_of_Tavistock	parents	monarch
do you know where NER customer come from	Ira_Goldstein	
who is the creator of NER's Notable Works	Sarah_Natochenny	notableworks	creator
do you know what is the specialty of Election after NER	Italian_general_election,_1992	afterelection	honorificsuffix
what is the profession of The name of the vessel of NER	Type_0891A_training_ship	
which party is the NER leader	印度尼西亚斗争派民主党	seats1title	party
where is the Alma Mater of The Leader of NER	United_Kingdom_general_election,_1886_(Ireland)	leader	title
what is the type of The name of NER	List_of_awards_and_nominations_received_by_Billy_Ray_Cyrus	name	genre
do you know where the headquarters of NER Country, a civil war, participant is located?	刚果共和国内战	commander	office
what was the last term of the Country of NER, a war, participant?	爱尔兰内战	result	legislature
do you know what ethnicity belongs to NER's ship name?	Type_0891A_training_ship	
what are the important positions of The name of the ship of NER	SMS_Hindenburg	shipnamesake	children
what state is Election after NER, a wahl?	United_States_Senate_election_in_West_Virginia,_2014	afterelection	state
who is the actor in The Name of NER's Ship	Wet_Nellie	shipnamesake	studio
do you know what is the name of the administrative district of The main city of NER	Canton_of_Nemours	chieftown	subdivisiontype
do you know what is the postalCodeType of the area where NER is used	晋城话	states	subdivisiontype
who was the last of Parents of NER, an american economist?	富兰克林·德拉诺·罗斯福三世	parents	before
do you know who is next to the NER coach	印度國家足球隊	name	studio
do You Know who Is NER's Timeline Wife	Someone_Put_Your_Hand_Out_(Michael_Jackson_song)	chronology	spouse
Did you know that the common languages of NER's country of origin, a footballer, were Congolese?	加布里埃尔·萨库亚尼	countryofbirth	ethnicity
do you know who the parents of The Children of the NER are	安華	children
what era did the eponym of NER come from	Haldane_(lunar_crater)	eponym	education
do you know what the southwest of NER country is	布莱德城堡	locationcountry	southwest
do you know who the NER timeline was before	The_Way_It's_Goin'_Down	chronology	position
who is the president of Election after NER, a wahl?	United_States_Senate_election_in_North_Carolina,_1990	afterelection	before
do you know what is the honorary suffix of The leader of NER	London_local_elections,_2018	leader	title
do you know what NER's eponymous job is	Cori_(lunar_crater)	eponym
what is the currency used in Events in NER, a geographic object?	Karelian_Autonomous_Soviet_Socialist_Republic	
where is the province of The name of the ship from NER	Italian_cruiser_Vittorio_Veneto	shipnamesake	region
do you know what is west in NER County, a town and civil parish in devon, united kingdom?	索爾科姆	shirecounty	status
do you know who the parents of NER's ship name are	HMS_Hecate_(1871)	shipnamesake	parents
do you know which stadium hosts the NER South	2010–11_Queens_Park_Rangers_F.C._season	
who are the descendants of Events in NER	Gurjara-Pratihara	event	issue
what is the final event of NER's name ship, a 1915 queen elizabeth-class battleship of the royal navy?	HMS_Malaya	shipnamesake	commonlanguages
where is the Alma Mater from NER's ship name	USS_Nitze	shipnamesake	title
do you know what the profession of Election is after NER	United_States_Senate_election_in_North_Carolina,_1998	afterelection	religion
what is the honorary suffix of Generals of the participating NERs	長岬之戰	commander	honorificprefix
what is the era of the NER name	Empedocles_(volcano)	name	era
do you know who NER's Client was before	Royal_Palace_of_Ficuzza	client	house
do you know who will be the next NER's ship's name, a Benson-class destroyer?	USS_Charles_F._Hughes_(DD-428)	shipnamesake	after	title
where is the alma mater of Persons Affected by an NER	阿兰·巴迪欧	influenced	almamater
what is the next term of the NER era, a precursor of the united kingdom of the netherlands from 1813 to 1815?	聯合尼德蘭主權公國	leader	succession
do you know NER manager business type	Vodacom_Cup	sponsor	companytype
who is the Prime Minister of NER's parents, an Irish politician?	Francis_Russell,_Marquess_of_Tavistock	parents	predecessor
what is the nationality of Election after NER	Civic_Democratic_Party_leadership_election,_1997	afterelection	title
what is the rank of people, things and things with the same name as NER?	German_destroyer_Mölders	shipnamesake	rank
what party belongs to NER's parents	Didit_Hediprasetyo	parents	party
do you know what is the southeast of the largest city in NER, a federated state of brazil?	马托格罗索州	largestcity	northeast
do you know what happened during the NER ship name	French_ironclad_Alma	shipnamesake
do You Know who Is The Mentor Of NER's Notable Works	Khalid_Siddiqui	notableworks	extra	profession
where is the title of The leader of NER, a general election of Spain?	Spanish_general_election,_1869	leader	title
where is the location of the NER Client	Ira_Goldstein	
who is the predecessors of Election after NER	Republic_of_China_presidential_election,_1918	afterelection	predecessor
who is the monarch whose leader is The name of the ship of NER	HMCS_Carleton	shipnamesake	monarch
what is the Royal Family of NER Client, a historic building in Corleone, Italy?	Royal_Palace_of_Ficuzza	client	before
what is the organizational model of the municipal management of the The name of the ship of NER	HMCS_Sherbrooke	
what is the honorary prefix of Generals of the participating NERs	瓦雷澤戰役	commander	honorificprefix
do you know what is establishedEvent in NER country	布莱德城堡	locationcountry	leadername	title
in which country is the Alma mater of NER, a politician?	Edward_McAlexander	almamater	country
do you know which league NER team one season football team will play in?	1923–24_Atromitos_F.C._season	team
what are the important positions of Election after NER	Northern_Cyprus_presidential_election,_2015	afterelection	office
do you know who is the responsible editor of NER	Armageddon_(2008)	sponsor	genre
what is the era of The Winner of NER, A Battle of the American Civil War?	第一次纽托尼亚战役	result	leader
what is the profession of NER's name	List_of_awards_and_nominations_received_by_Craig_David	name	profession
From what era did the The leader of NER come	Dervish_state	leader	placeofbirth
who is the creator of The NER Related Thing	女超人_(電視劇)	related	teleplay
do you know where the head of NER, a state, died?	Government_of_National_Salvation	leader	deathplace
do you know what is establishedEvent in NER Homelands	伊格尔·茨维塔诺维奇	countryofbirth	leadertitle
do you know where the origin of the name of the NERdied	Lippershey_(crater)	eponym
what is the house of The descendant of NER	貝倫加利亞_(卡斯蒂利亞)	issue	house
what is the time zone used by Northwest of NER	Torres_de_Segre	nw	timezone
do you know who is the wife of NER's ship name	French_ship_Alexandre_(1857)	shipnamesake	succession
who is the predecessor of Events in NER, an indian dynasty that ruled much of northern india from the mid-8th century to the 11th century?	Gurjara-Pratihara	event	issue
what happened in The Winner of NER, A Battle of the American Civil War?	第一次纽托尼亚战役	result	leader
where is the location of NER's Alma mater	Phil_Bentley	almamater	location
what is the time zone used by NER ship name	HMCS_Wetaskiwin	shipnamesake	timezone
do you know who is the leader of the The leader of NER	Michael_Ellis_(British_politician)	leader	honorificprefix
do you know what religion the person who affects NER believes, an italian general, patriot and republican?	朱塞佩·加里波底	influences	religion
what are the children of NER Parents, a mythical character?	涅莱乌斯	parents	children
what is the type of The province where the NER is located	Kallazhagar_Temple	state/province	type
do you know what the royal family belonged to NER's ship name	RV_Kronprins_Haakon	shipnamesake	issue
who is the president of the head of NER, a wwf's 1994 summerslam pay-per-view?	SummerSlam_(1994)	sponsor	founder
what is the famous eponymous work of NER	Boltzmann_(crater)	
do you know who is the heir of The leader of NER	Colony_of_Greenland_(1950–53)	leader	successor
do you know who is the father of Events in NER, an indian dynasty that ruled much of northern india from the mid-8th century to the 11th century?	Gurjara-Pratihara	event	issue
do you know who Next to NER, a japanese general and war criminal, is loyal to?	Takashi_Sakai	
where is the administrative center of NER South	Garrigues_(comarca)	s	postalcodetype
where does the religion of Election after NER come from	United_States_Senate_election_in_Nebraska,_2002	afterelection	religion
do you know who will be the next Customer of NER	Royal_Spring,_Warsaw	client	title
do you know where is the birthplace of NER's ship name	Otto_Hahn_(ship)	shipnamesake	field
do you know where is the birthplace of The father of NER	東伏見慈洽	father	fatherofwife	title
do You Know where NER Related Things Come From	Axe_(brand)	related	parent
what is the type of Theme of NER, an area in universal studios japan?	The_Wizarding_World_of_Harry_Potter_(Universal_Studios_Japan)	theme	genre
do you know who is the regent of Les enfants du NER, a British politician (1836-1914)?	约瑟夫·张伯伦	children	successor
do you know what language is used in NER's ship name	MF_Tysnes	shipnamesake	language
what are the countries of NER's name, a wikimedia list article, participating?	Germanic_Wars	
do you know who is the president of Alma mater of NER	Shin_Chang-jae	almamater
do you know who is the NER Theme Mentor	Skull_Island:_Reign_of_Kong	theme	genre
do you know what is the description of the map of NER's ship name	French_ship_Polyphème_(1815)	shipnamesake	subdivisiontype
do you know what is the title of Nickname of NER	思希	nickname	title
what is the predecessor of Parents of NER	贾瓦哈拉尔·尼赫鲁	children	before
do you know what is the battle of The name of the ship of NER, an udaloy-class destroyer of the russian navy?	Russian_destroyer_Marshal_Shaposhnikov	shipnamesake	rank
do you know what is the eponymous type of NER	Bolsena_Lacus	
what is the type of parts of The sea around the NER	米洛斯岛	archipelago	type
who was the person or things that share the same name with NERavant	Cornwallis_(1787_ship)	shipnamesake	honorificprefix
who is the cast member of NER's Theme, a 2016 ride at universal's islands of adventures?	Skull_Island:_Reign_of_Kong	theme	director
do you know where is the heir of Generals of the participating NERs	莱尼亚诺战役	commander	succession
do you know where the capital of NER's ship name is	HMS_St._Helena_(K590)	shipnamesake	establishedevent	status
do you know what is the problem of Generals of the participating NERs	定陶之戰_(東漢)	commander	dynasty
what is the origin of Famous Works of NER	迈尔·阿姆谢尔·罗斯柴尔德	knownfor	origin	event
where is the description of The area where NER, a language of the baekje kingdom in ancient korea, is used?	百濟語	states	country
What's before Generals of participating NERs	美国南方司令部	commander	awards
who is the predecessor of Beside NER	Felix_Chung	
do you know who is the mentor of the NER team	Red_Bull_RB12	team	founders
what are the important positions of Beside NER	Hyon_Yong-chol	alongside	office
do you know what is the maker of NER-related things, a practical model von nokia?	Nokia_E5-00	related	series
do you know which national team belongs to NER South	Seattle_Sounders_FC_2	s	topics
where did Election die after NER, a wahl?	Haitian_presidential_referendum,_1961	afterelection	deathplace
who is the source of NER's eponymous information?	Penticton_(crater)	eponym	south
do you know who are the generals involved in the Master of NER	INS_Trata	controlledby	branch
what is the predecessor of The Descendant of NER	貝倫加利亞_(卡斯蒂利亞)	issue	predecessor
do you know where is the eponymous title of NER	Haldane_(lunar_crater)	eponym	title
who influenced Client de NER, an architectural structure in city of edinburgh, scotland, uk?	Ramsay_Garden	client	influences
where is the NER Client title	Royal_Spring,_Warsaw	client	title
do you know what is the name of the administrative district of Southern NER	Vall-llobrega	
what is the level of management in Northwest of NER, a municipality in the comarca of osona in catalonia, spain?	Gurb	
do you know where is the eponymous address of NER	Cori_(lunar_crater)	eponym
where does the religion of Cities affected by NER come from?	2006_Yogyakarta_earthquake	countriesaffected	religion
do you know where the artist who sings for NER is spoken	Languages_of_Papua_New_Guinea	extra	fam
do you know who is next to the NER children	约瑟夫·张伯伦	children	order
do you know which domain belongs to The name of the ship from NER	Akademik_Lomonosov	
what is the name of the administrative division of the province where the NER is located	Khökh-Adar_mine	state/province	subdivisionname
do you know where is the region of The province where the NER is located	Alderley_Edge_Mines	
where is the position of the Events in NER	Empire_of_China_(1915–16)	
do you know what religion believes in The main organ of NER chiefs	热那亚总督	body	religion
do you know what the problem of The Descendant of NER is	利奥波德四世_(安哈尔特)	issue	succession
what is the rank of Election after NER?	Guatemalan_general_election,_2011	afterelection	rank
who is the mother of The leader of NER	Albanian_Kingdom_(1928–39)	leader	issue
what religion Does NER, an algerian footballer, come from?	罗内斯·加瓦维	countryofbirth	officiallanguage
do you know what type of settlement is in the province where NER mine in mongolia is located?	Khuut_coal_mine	state/province	seat
do you know who is the predecessor of The name of the ship of NER	USS_Windom_(1896)	shipnamesake	before	title
do you know what the program format of Notable Works of NER is?	Aleks_Krotoski	notableworks	channel
what is the birthplace of Generals of participating NERs	第二次大马士革农村省攻势	commander	occupation
do you know where the birthplace of Persons affected by an NER is?	伯納德·劉易斯	influenced	birthplace	currencyunit
what is the honorific suffix of Election after NER, a by-election in New Zealand?	Rangitikei_by-election,_1880	afterelection	honorificsuffix
where is the burial Place of NER's descendant	拉米羅一世_(阿斯圖里亞斯)	issue	birthplace
do you know who is the chief of the area where NER, a language of the baekje kingdom in ancient korea, is used?	百濟語	states	country
what is the status of Participating NER Country	嘉義之役	combatant	status
do you know what is the source of the Country of NER, a middle-earth, participant?	班戈拉赫戰役	combatant	source
who Influenced NER's Ship Name	MS_Henrik_Ibsen	
what is the type of NER addition	I'm_So_Sorry	extra	title
do you know what Election run agency is after NER	German_federal_election,_1920	afterelection	deathplace
do you know which party belongs to NER ship name	USRC_Bibb_(1843)	shipnamesake	party
do you know who will be the next Election after NER	French_legislative_election,_1893	afterelection	successor
who is the architect of the The name of the ship of NER	Osterley_(1780_EIC_ship)	shipnamesake	architect
do you know when the NER Timeline came from	Can_I_Borrow_a_Dollar%3F	chronology	format	owner
do you know what is setEvent to the area where NER, a language, is used?	翁果塔語	states	internationaldomainabbreviation
do you know where the alma mater of Election is after NER	United_States_Senate_election_in_North_Carolina,_1998	afterelection	religion
do you know what is the country of NER Client	Warner_elevator_row	
do you know what is the problem of The winner of NER, a 1106 battle during the invasion of normandy by henry i?	坦什布赖战役	result	successor
what are the awards won by eponym from NER	Meitner_(Venusian_crater)	eponym	awards
do you know where is the capital of Events in NER	First_Hungarian_Republic	event	titleleader
where is NER's eponymous birthplace, a lunar impact crater?	Hevelius_(crater)	eponym	birthplace
do you know who is the head of the The main organ of the heads of NER	热那亚总督	body	titleleader
who is the founder of the Master of NER	Brownsea_Castle	controlledby	founder
what is the label of the area where NER, a language, is used?	翁果塔語	states	title
who is the successor of Generals of the participating NERs	定陶之戰_(東漢)	commander	successor
who are the children of the Election after NER, a wahl?	South_Korean_presidential_election,_1978	afterelection	children
what is the era of the Events in NER, a former country?	Kingdom_of_Galicia_and_Lodomeria	
do you know what is the name of the administrative district of Northwest of NER	Arbúcies	nw	subdivisiontype
do you know what the sea is around the NER ship name	USS_Tutuila_(ARG-4)	shipnamesake	archipelago
what is the time zone used by NER South	Poboleda	s	n
do you know who is the creator of NER Timeline	It's_a_SpongeBob_Christmas!_Album	chronology	creator
what is the subdivisionRanks of The name of the vessel of NER	Marsouin_(1788_ship)	shipnamesake	subdivisionranks
what is the label of L'addition de NER, an album by omarion?	Ollusion	extra	label
do you know who is the father of NER's ship name	Maud_(ship)	shipnamesake	succession
who is the NER team manager for fall 2016-2017?	1968–69_FDGB-Pokal	team
who is Next to NER's Wife	Dong_Biwu	
do you know who the successor to The NER Related Thing is	Sony_Xperia_Z2a	related	type
what is the level of management at NER's vessel name	HMCS_Peterborough	shipnamesake	subdivisiontype
which party belongs Election after NER, a wahl?	United_States_Senate_election_in_West_Virginia,_2014	afterelection	party
what is the name of the administrative division of The name of the vessel of NER	HMCS_Kamloops	shipnamesake	subdivisionname
do you know what is the region of Famous works of NER, a german banker?	迈尔·阿姆谢尔·罗斯柴尔德	knownfor	region	legislature
what is the house of The father of NER	懷寧公主	father	succession
do you know what is the management level of North East of NER World Day Venue	1993_NBA_Playoffs	place	lowerhouse
where is the city of The location of The stadium where NER was held, a 30th season of top-tier soccer league in australia?	2006–07_A-League	stadium	before
what is the honorific suffix of Occupied people of The title of NER	Peter_Mandelson	
who is the head of the Front of NER location	2015_Beijing_Guoan_F.C._season	location	west
do you know what is the postcode of the south west of NER World Day Location	Seattle_Arctic_drilling_protests	place	timezone
what dynasty does The Life of NER World Day Place belong to?	2015–16_FC_Barcelona_Bàsquet_season	club	owner
what is the level of management in Northeast of NER's title	Drugs,_Inc.	title	north	timezone
what is the time zone used by NER's North of Millionaires, a wikimedia listing article?	National_Register_of_Historic_Places_listings_in_Davis_County,_Utah	city	north	timezone
what time zone does Northeast of Southeast of NER use?	Scofield,_Utah	
what are the important positions of Name of the leader of The party of NER	Perlis_State_Legislative_Assembly	party	position
do you know who the front of NER's photo caption was before	Boston	
what is the language used in Area covered by the NER location, a football team season?	2016_Beijing_Guoan_F.C._season	location	east
do you know what is the name of administrative district of Capital of NER location	Abu_Simbel_temples	location	cctld
what is the timezone used by Northeast Stadium where NER, an nfl team season was held?	1994_Seattle_Seahawks_season	stadium	legislature
do you know what is the management level of The South of NER World Day Venue	2013_ABL_Playoffs	place	northeast
what dynasty belongs to The Life of NER Site, an American college basketball season?	2015–16_Iona_Gaels_men's_basketball_team	home	establishedevent
do you know what is the name of the administrative district of South East of NER site	2015–16_Kentucky_Wildcats_men's_basketball_team	home	establishedevent
do you know what is the management level of Western NER location	Sabah_International_Convention_Centre	location	cctld
do you know what time zone uses North Western NER, a municipality in gelderland, the netherlands?	Oude_IJsselstreek	postalcodetype
do you know what is the name of the administrative district of the South of the West of NER	Bicknell,_Utah	
what is the level of management West of South of NER	Marysvale,_Utah	
do you know what is the management level of Northern Headquarters of NER	Canadian_Baptists_of_Western_Canada	headquarters	cctld
what is the name of the administrative division of South of Southeastern NER, a city in and county seat of millard county, utah, united states?	Fillmore,_Utah	
who is the leader of the Northern NER location	Netherlands_at_the_2015_World_Speed_Skating_Championships	location	label
do you know the language family of the common languages of The stage where the NER took place	1972_African_Cup_of_Nations_qualification	stadium	politicalsystem
who will be the front of the NER location next	2012_Jiangsu_Sainty_F.C._season	location	east
what is the name of the administrative division of Le sud de NER, un municipality in baix llobregat, catalonia, spain?	Begues	s	subdivisionname
what is the house of The father of NER	鄭梉	issue	house
do you know what is the name of the administrative district of The Northwest Site of NER, an American college basketball season?	2014–15_Utah_State_Aggies_men's_basketball_team	home	subdivisiontype
which party belongs to Election after NER	Mongolian_legislative_election,_2008	afterelection	party
who is the father of Regent from The question of NER	Princess_Maria_Pia_of_Bourbon-Two_Sicilies_(1849–1882)	
do you know where NER leader died	French_National_Convention_election,_1792	leader	deathplace
do you know what is the succession of L'avant de La question de NER, a last Holy Roman Empress and first Empress of Austria?	Maria_Theresa_of_Naples_and_Sicily	issue	religion
what is the ZIP code for the South West location of NER, a football tournament season?	2015_Lamar_Hunt_U.S._Open_Cup	location	namedfor
what is the Typical Settlement of Western NER Region	Cordillera_Central_(Luzon)	region	northeast	subdivisiontype
do you know what are the subdivision ratings of the NER ship name	USS_Torchwood_(AN-55)	shipnamesake	subdivisionranks
do you know who is the wife of Election after NER	United_States_presidential_election_in_Wisconsin,_1880	afterelection
do you know where is the title of Election after NER, a wahl?	United_States_Senate_election_in_Georgia,_2014	afterelection	title
what is the name of the administrative division of NER Site West, a season of American college basketball?	2014–15_South_Dakota_State_Jackrabbits_men's_basketball_team	home	capital
what is the time zone used by NER Eastern West	Administrative_divisions_of_Ilocos_Sur	east	southwest	north
what is the level of management in the Northwest of the Southwest of NER	Laketown,_Utah	
do you know what is the management level of The northeast of NER's place of death	John_James_Joseph_Monaghan	deathplace	legislature
who is the head of the Area covered by the The stadium where the NER took place	2014_Malaysia_Premier_League	stadium	west
do you know what is the name of the administrative district of Eastern Site of NER, a season of American college basketball?	2013–14_UC_Santa_Barbara_Gauchos_men's_basketball_team	home	subdivisiontype
do you know who is next to the Generals of the participating NERs	長岬之戰	commander	honorificsuffix
do you know which national team belongs to The coach of NER's club, a wikimedia list article?	UEFA_Euro_2016_squads	name
What's wrong with The Father of NER	弘農公主	father	regent
what is the birthplace of The Father of NER	東伏見慈洽	father	workinstitutions
do you know who was the forward of The NER location, a football team season, before?	2014_Shanghai_Greenland_Shenhua_F.C._season	location	title
where is the title of Election after NER	United_States_Senate_election_in_South_Dakota,_2014	afterelection
what are the important positions of NER's ship name, un barku den noruega?	MS_Thorbjørn	shipnamesake	office
what time zone does Northeast of The stadium where the NER took place	2008_Seattle_Seahawks_season	stadium	legislature
do you know what is the name of administrative district of Western NER location	2013–14_Gimnàstic_de_Tarragona_season	location	w
do you know what country the NER location photo caption is	2016–17_Huddersfield_Town_A.F.C._season	location	currency
do you know what type of The thing related to NER	Sony_Xperia_Z2a	related	type
where is the position of the Vessel name of NER	Italian_battleship_Vittorio_Veneto	
where is the city of The location of The stadium where the NER took place	New_Zealand_at_the_Rugby_World_Cup	stadium	before
do you know where is the city of The operator of The stadium where the NER took place	2009–10_Ergotelis_F.C._season	stadium	operator	league
who will be Election after NER next	Bulgarian_parliamentary_election,_1986	afterelection	after
do you know what time zone is West of The place of death of NER, a german world war ii stuka pilot and neo-nazi activist?	Hans-Ulrich_Rudel	
do you know who is the wife of Election after NER	South_Korean_presidential_election,_1978	afterelection	religion
do you know what timezone the Northeast of The stadium where NER took place, a 38th season in franchise history; first super bowl win?	2013_Seattle_Seahawks_season	stadium	ethnicgroups
who is the predecessors of The leader of NER	Mongolian_legislative_election,_2016	leader	predecessor
do you know what is the management level of Area covered by the NER location	1994–95_Wolverhampton_Wanderers_F.C._season	location	cctld
What's before Generals of participating NERs	界河戰鬥_(抗日戰爭)	commander	before
do you know what time zone uses The province where the NER is located	Dhua_Kund	state/province	timezone
what is the name of the administrative division of the southwest of NER's location	2011–12_AZ_Alkmaar_season	
do you know who was the Front of World NER Day Venue before	2016_CBA_Playoffs	place	position
do you know what currency is used in NER Location Release Event	2014_Davis_Cup_Americas_Zone_Group_I	venue	internationaldomainabbreviation
what Happened in the Time of NER's Ship's Name	Russian_ship_of_the_line_Gangut_(1825)	shipnamesake	partof
what is the name of the administrative division of Southern Eastern NER, a town in millard county, utah, united states?	Kanosh,_Utah	
do you know who is the heir of Occupied people of The title of NER	Margaret_Beckett	
what time zone uses North of The place of death of NER, a medal of honor recipient?	Henderson_C._Howard	deathplace	legislature
do you know what time zone uses West of Southwest of NER	Rotterdam	
what is the time zone used by South of Southeastern NER, a city in and county seat of millard county, utah, united states?	Fillmore,_Utah	
what is the name of the administrative division of the southwest of the northwest of NER	Scofield,_Utah	
who is the heir to NER's ship name	Alfa_Nero	
do you know who is the leader of the South of NER site	2014–15_Santa_Clara_Broncos_women's_basketball_team	home	subdivisiontype
what condition is NER's ship name an arleigh burke class destroyer in?	USS_Carl_M._Levin	shipnamesake	before
what musical instrument did NER's name use	List_of_awards_and_nominations_received_by_Billy_Ray_Cyrus	name	occupation
do you know what is the management level of North of Northwestern NER, a town in sevier county, utah, united states?	Koosharem,_Utah	
what is the Famous Work of NER Client	Heathfield_Hall	
what is the name of the administrative division of The name of the vessel of NER	INS_Kavaratti	shipnamesake	countryadmindivisions	subdivisionname
what is the common language of the NER Location Release Event	Eastern_Tepuis	location	legislature
do you know what time zone is in Club in which The stadium where the NER took place is part	2006_UEFA_European_Under-17_Championship	stadium	se
what is the name of the southwestern administrative division of NER Millionaires, a wikimedia listing article?	National_Register_of_Historic_Places_listings_in_Utah_County,_Utah	city	southwest
what is related to NER's ship name, un barku den estadonan uni di merka?	Chilean_brigantine_Araucano	
do you know where is the province of the southwestern Administration of NER	Lakawon	countryadmindivisions	southwest
where does the religion of NER's ship name come from?	USNS_John_Lewis_(T-AO-205)	shipnamesake	religion
do you know where is the title of The name of the ship of NER	Cornwallis_(1787_ship)	shipnamesake	honorificprefix
do you know who is the predecessor of The busy people of The title of NER	Soong_Ching-ling	
do you know who is the leader of the NER's ship name	HMCS_Lachine_(J266)	shipnamesake	subdivisiontype
who is the manager of Tenants of The stadium where the NER took place, a football team season, for the fall of 2016-2017?	2012_Montedio_Yamagata_season	stadium	tenants	manager
what is the level of management at the South of The stadium where the NER took place	2008_Houston_Dynamo_season	stadium	capital
do you know who was the people, things and things with the same name as NER before	Spanish_cruiser_Don_Antonio_de_Ulloa	shipnamesake	field
do you know where the birthplace of NER's Coach is?	哈菲兹哈欣	coach	subdivisiontype
do you know who is the predecessor of The name of the ship of NER	USRC_McLane_(1832)	shipnamesake	religion
what is the education level of The addition of NER, a 2013 south korean romantic melodrama television series?	That_Winter,_the_Wind_Blows	
do you know who is the Premier agent of NER Predecessor, a Taiwanese politician?	Yu_Shyi-kun	
do you know what is the name of the administrative district of the south of the south-west of NER	Clarkston,_Utah	
do you know what is the management level of Southern Place of NER	2003_IWCC_Trophy	venue	areacodetype
do you know where is the birthplace of the city of Captain of The club of NER	2005_FIFA_World_Youth_Championship_squads	name
do you know who was the Your next club L'avant de NER, a French politician (1885-1956), before?	Yvon_Delbos	
what is the royal family of The name of the ship of NER	SS_Prinses_Astrid	shipnamesake	succession
what is the national team of The coach of The club of NER, a wikimedia list article?	2015_FIFA_U-17_World_Cup_squads	club
who are the children of NER's name	Hades_in_popular_culture	name	parents
who is the mother of Your next club The question of NER	Juan_Carlos_I_of_Spain	
do you know who is the predecessor of Election after NER	Italian_general_election,_1992	afterelection	honorificsuffix
do you know who is the leader of the Publication event of NER location, a gebeurtenis to jaar?	2012–13_in_Argentine_football	location	politicalsystem
do you know what is the occupation of Chronology of NER, a 2001 album?	Themes_from_Calmi_Cuori_Appassionati	chronology	profession
do You Know which Party Belongs to NER's Location Life	Polonia_(train)	locale	legislature	house
who was the person or things that share the same name with NERavant	HMS_Tarleton_(1782)	shipnamesake	deathplace
do you know what is the management level of The Northeast Site of NER, an American college basketball season?	2016–17_Idaho_Vandals_men's_basketball_team	home	subdivisiontype
do you know what are the subdivision ratings of the NER ship name	HMS_Falcon_(1820)	shipnamesake	subdivisionranks
do you know what state is East of NER location	2011–12_TSW_Pegasus_FC_season	location	east	subdivisiontype
do you know who is the predecessor of Your next club L'avant de NER, a French politician (1885-1956)?	Yvon_Delbos	
do you know what is the management level of The South of NER location, a wikimedia list article?	List_of_Cultural_Properties_of_the_Philippines_in_Calabarzon	location	south	subdivisiontype
who is the leader of the Northeast NER location	2013_Kashiwa_Reysol_season	location	establishedevent
what is the title of The Descendant of NER	吉增·佩玛	issue	title
do you know what is the management level of The Northeast of NER Millionaires, a wikimedia list article?	National_Register_of_Historic_Places_listings_in_Los_Angeles_County,_California	city	areacodetype
which party belongs to Election after NER	National_Liberation_Party_presidential_primary,_2009	afterelection	party
who is the leader of the East of The stadium where the NER took place	2013_AFC_Champions_League_knockout_stage	stadium	before
do you know where the constituency of the West of NER's place of death is	Joost_de_Blank	
In what condition is NER's Alma mater	Peter_Bramley_(biochemist)	almamater	affiliations
do you know where the Northeast of NER's location is, a football team season?	2013–14_South_China_AA_season	team
do you know where is the constituency of the North of NER location, a football team season?	2011–12_Portsmouth_F.C._season	location	subdivisiontype
where is the city of The operator of The stadium where the NER took place	2008–09_Coventry_City_F.C._season	stadium	operator	city
do you know what is the management level of NER south	Garrigues_(comarca)	s	postalcodetype
what is the level of management in Area covered by NER Region	Sudan_Revolutionary_Front	area	seat
do you know where is the city of Alma mater de NER, an american football coach?	Bob_Padilla	
do you know what is the name of the administrative district of Nord-Ouest de NER, a municipality in Flemish Brabant, Belgium?	Pepingen	nw	discoverer	organization
do you know what important positions Election has after NER	Lithuanian_parliamentary_election,_2000	afterelection	title
what is the level of management at Southwest NER South, a town in piute county, utah, united states?	Marysvale,_Utah	
what is the next term of the NER national team club	塞巴斯蒂安·迈尔	nationalteam	club	other
who are the parents of NER's ship name	USS_Joseph_P._Kennedy_Jr._(DD-850)	
what is the western national team location of NER, a hong kong association football player?	彭梓鍵	nationalteam	location
do you know who is the mentor of the NER addition	3/8_(album)	
do you know what is the management level of NER ship name	HMCS_Parry_Sound	
do you know what time zone Southwest of North NER, a town in utah county, utah, united states uses?	Goshen,_Utah	
who is the heir of Election after NER	Iranian_legislative_election,_1956	afterelection	successor
where is the address of the NER team	1986_Paraguayan_Primera_División_season	team
do you know who is the leader of the NER's ship name	Russian_submarine_Severodvinsk_(K-329)	shipnamesake	leadername
do you know where the constituency of the West Venue of NER, a sportseizoen van een cricketcompetitie, is?	1993_Women's_Cricket_World_Cup	venue	source	draftteam
do you know what timezone uses Southwest from NER West	Loa,_Utah	
what is the NER Location Release Event	2015_LA_Galaxy_season	location	establishedevent	commonlanguages
do you know what kind of NER addition	I'm_So_Sorry	extra	title
what is the ideology of NER's ship name, a russian cruiser?	Soviet_cruiser_Komintern	shipnamesake	ideology
what is the level of management West of NER's place of death	John_Wainwright_(Medal_of_Honor)	deathplace	legislature
do you know what is the name of the administrative district of NER Millionaires South, a mountain range in millard and sevier counties in utah, united states?	Pavant_Range	city	postalcodetype
do You Know where Your Next Club from The NER Question Died	Blanche_of_Namur	issue	regent
what language does NER addition, a 2013 south korean romantic melodrama television series use?	That_Winter,_the_Wind_Blows	
do you know what time zone uses NER South	Osor,_Girona	nw	subdivisiontype
what musical instrument did NER, a sovereign state in south america, use?	Heart_&_Soul_(Ron_Carter_and_Cedar_Walton_album)	chronology	instrument
do you know what is the program format of The title of NER World Day Venue?	2016_CBA_Playoffs	place	position
what is the type of division of The North of City of birth of NER	羅賓奴	position
do you know who was touched by NER's eponymous	Mach_(crater)	eponym	workplaces
what is the name of the administrative division of the North of The stadium where the NER took place	2013_St_Helens_season	stadium	imagecaption	locationcountry
what is the name of the administrative division of Eastern NER Millionaires, a wikimedia listing article?	National_Register_of_Historic_Places_listings_in_Wasatch_County,_Utah	city	south	subdivisionname
where is the title of Your next club The question of NER	Mary_of_Hungary,_Queen_of_Naples	issue	title
do you know what is the name of administrative district of West of NER site	2014–15_Utah_State_Aggies_men's_basketball_team	home	subdivisiontype
what is the name of the administrative division of the southwest of The stadium where the NER, a football team season, took place?	2009–10_Al_Ain_FC_season	stadium	southwest
do you know who is the president of the Tenants of The stadium where the NER took place	2011_Emperor's_Cup	stadium	autonomousbody	islandisland
do you know what is the name of the administrative district of the south-west of The stadium where the NER took place, a gebeurtenis in jaar?	2011–12_in_French_football	stadium	title
what is the type of The name of NER	List_of_awards_and_nominations_received_by_Lorde	name
who is the president of Alma mater de NER, a chinese actress?	Deng_Jiajia	almamater	president
do you know what is the management level of Western NER Millionaires	CBU-FM	city	west
do you know what is the common language of the NER Location Release Event	Colombia_national_football_team_results_(2000–19)	location	cctld
do you know what is the name of the administrative district of The Northwest of NER Millionaires, a wikimedia list article?	National_Register_of_Historic_Places_listings_in_King_County,_Washington	city	timezone
who is the wife of The next term of The question of NER, an heir apparent to the Margraviate of Baden?	Charles_Louis,_Hereditary_Prince_of_Baden	issue	after
do you know what time zone uses Club in which NER location, a football team season, is part?	2011–12_Lleida_Esportiu_season	location	e	timezone
do you know who is the predecessor of The name of the ship of NER	French_cruiser_Georges_Leygues	shipnamesake	title
do you know who was the Election after NER before	Spanish_general_election,_1931	afterelection	title
who is the heir to NER's ship name	Egyptian_sloop_El_Amir_Farouq	shipnamesake	issue
what is the northeast location of NER's national team, an association football player?	林驍城	countryofbirth
do you know what is the traditional shape of the forward of NER's club?	2016_AFC_U-23_Championship_squads	name
who is the leader of the East of The stadium where the NER, an international football competition, took place?	2002_FIFA_World_Cup_qualification_–_AFC_First_Round	stadium	west
what eponymous domain of NER belongs to	D'Alembert_(crater)	eponym	field
do you know who was the front of NER's location before	Australia_women's_national_soccer_team_results_(2000–09)	location
where are the heirs of Generals of the participating NERs	白藤江之战_(938年)	commander
do you know what is the rank of Next to NER	Takashi_Sakai	
do you know where is the city of Alma mater from NER	Wayne_Chabre	almamater
who is the heir to the front of NER's title	The_Complete_Guide_to_Everything	
do you know who the generals involved in the NER ship name are	French_ironclad_Marengo	shipnamesake	commander
do you know where is the city of Alma mater from NER	Ed_Jackson_(Tennessee_politician)	almamater
what is the time zone used by Eastern of Southern NER	Molenwaard	north	timezone
what is the famous eponymous work of NER	Viviani_(crater)	eponym	knownfor
who are the people affected by NER's ship name, a container ship?	CMA_CGM_Alexander_von_Humboldt	shipnamesake	influences
what are the awards won by The first of The title of NER	John_M._Loh	title	first	awards
what is the traditional shape of the forward of NER's club	2016_AFC_U-23_Championship_squads	name
what is EstablishedEvent at NER Country	國際發明聯盟協會	locationcountry	largestcity
do you know what are the subdivision ratings of the NER ship name	HMS_Jaseur_(1807)	shipnamesake	subdivisionranks
who is the leader of the Northwest NER location	2015–16_in_Hong_Kong_football	location	west
do you know where the religion of The name of the ship of NER, an italian line passenger ship, comes from?	MS_Giulio_Cesare	shipnamesake	as
do You Know what Language Lyrics Of NER's Title Is Using	The_Beat_Goes_On_(Super_Junior_D&E_album)	title	genre
do you know who is the predecessor of The name of the ship of NER	French_ship_Alexandre_(1857)	shipnamesake	succession
do you know what awards the person or things that share the same name with NER, a canadian forces naval reserve unit based in ottawa, ontario, won?	HMCS_Carleton	shipnamesake	rank
what are the eponymous prizes won by NER, a lunar impact crater?	Fermi_(crater)	eponym	awards
what is the next term of the father of NER, a son of emperor go-murakami?	惟成親王	father	after	mother
do you know what is the title of the seats of the location of the National team of NER, a footballer?	海因里希·施密特加尔	nationalteam	location	title
who was the Predecessor of L'avant de NER before	Pierre_Pflimlin	
what is the name of the administrative division of Southern NER	Vilallonga_de_Ter	nw	subdivisionname
who is the predecessors of The Parents of NER	Francis_Russell,_Marquess_of_Tavistock	parents	predecessor
do you know what is the district of The main city of NER, a canton of France?	Canton_of_Moreuil	chieftown
do you know what the profession of NER addition is?	Boysitter	extra
what is the level of management at NER South	La_Nou_de_Gaià	s
what are the important positions of Beside NER, a hong kong politician?	Felix_Chung	
do You Know who Will Be Next The Ahead Of NER's Question	Archduchess_Maria_Beatrix_of_Austria-Este	
do you know what time zone uses Southeastern NER location a football team season?	2012_Santos_FC_season	location	politicalsystem
where does the religion of Election after NER come from	Labour_Party_(UK)_deputy_leadership_election,_2015	afterelection	honorificsuffix
do you know where NER's The Name of the Ship takes place?	Russian_ship_of_the_line_Gangut_(1825)	shipnamesake	place
do you know who is the leader of the Eastern NER location	2014–15_Bengaluru_FC_season	location	religion
what is the name of the administrative division of Southern NER County, a wikimedia listing article?	List_of_National_Historic_Landmarks_in_Massachusetts	countycounty	west
do you know where is the address of the tenants of the stadium where the NER took place, a football team season?	2015–16_Atlético_Madrid_season	stadium	title
do you know what is the specialty of Inaugural speech of The title of NER, a former general secretary of the Lao people's revolutionary party (2016-2021)?	Bounnhang_Vorachith	
what are the important positions of Election after NER, a wahl?	United_States_Senate_election_in_North_Carolina,_1998	afterelection	occupation
what is the name of the administrative division of Southern Site of NER	2014–15_Washington_Huskies_women's_basketball_team	home	east
do you know where the religion of NER's ship's name comes from	French_ship_Charlemagne_(1852)	shipnamesake	subdivisiontype
where is the Alma Mater of Election after NER, a wahl?	United_States_Senate_election_in_West_Virginia,_2014	afterelection	state
do you know who is the leader of the The North West of The stadium where the NER took place, a sportseizoen van een voetbalcompetitie?	2013_AFC_Champions_League_group_stage	stadium	title	format
do you know where the Northeast of NER site is, an intercollegiate basketball season?	2016–17_Houston_Cougars_women's_basketball_team	home	northwest	subdivisiontype
do you know who is the leader of The life of The stadium where the NER took place, an nfl seasonal playoff games?	2013–14_NFL_playoffs	stadium	type
what is the level of management at NER South	Puiggròs	s	subdivisiontype
what is the common language of the NER Location Release Event	2010–11_C.D._Motagua_season	location	seat	blankinfo
In what state is The name of the ship from NER	Japanese_cruiser_Mogami_(1934)	shipnamesake
where is NER's eponymous death place	Barringer_(lunar_crater)	eponym	field
what is the name of the administrative division of Birthplace of L'avant de NER, an american comics writer?	Karl_Kesel	before	birthplace	subdivisionname
do you know what is the famous work of NER's eponymous	Eijkman_(crater)	eponym
do you know what is the name of the administrative district of The Northeast of The stadium where the NER took place	2017_World_Men's_Handball_Championship_–_European_qualification	stadium	timezonedst
do you know what is the name of the administrative district of Western NER Millionaires, a wikimedia list article?	National_Register_of_Historic_Places_listings_in_Cache_County,_Utah	city	postalcodetype
in which state is the Area covered by the NER location, a football team season?	2014_Shanghai_Greenland_Shenhua_F.C._season	location	seat	state
do you know who is the mother of NER's ship name	French_frigate_Cléopâtre_(1781)	shipnamesake	issue
do you know that before the person or thing related to the result caused by NER is?	霍邑之战	result	succession
do you know where is the title of Inaugural Speech of The title of NER, a British politician (born in 1943)?	Margaret_Beckett	
do you know who is the head of the The head of the NER	苏格兰保守党	leader
do you know where is the administrative center of the province where the NER is located	Chandgana_Tal	state/province	seat	subdivisiontype
do you know what is the title of The winner of NER, a 1106 battle during the invasion of normandy by henry i?	坦什布赖战役	commander	title
what is the time zone used by The North West of the South West of NER	Emery,_Utah	
what is the level of management at NER's Southeast Site, an intercollegiate basketball season?	2011–12_BYU_Cougars_women's_basketball_team	home	east
what Happened in the Time of NER's Ship's Name	French_ship_Rivoli_(1810)	shipnamesake	partof
what is the Model Regulation of The province where the NER is located	Koksay	state/province	settlementtype
do you know where is the address of The operator of The stadium where the NER took place, a football team season?	2012–13_PAOK_FC_season	stadium	tenants
do you know who is the president of NER's ship name	USS_Windom_(1896)	shipnamesake	before	title
do you know who is the predecessor of Inaugural speech of The title of NER	Milton_Obote	
do you know what time zone is in East of NER location, a football team season?	2010–11_Valencia_CF_season	location	subdivisiontype
what is the nationality of Election after NER	Brazilian_presidential_election,_1960	afterelection	timezone1dst
what are the products of The owner of NER's club, a wikimedia list article?	Baseball_at_the_2008_Summer_Olympics_–_Team_squads	name	subdivisiontype
what is related to responsible for NER	Coca-Cola_Topnotchers	sponsor	type
do you know what is the name of the administrative district of The North of NER Millionaires	National_Register_of_Historic_Places_listings_in_Davis_County,_Utah	city	subdivisiontype
where is NER's eponymous Alma Mater	Harden_(crater)	eponym	knownfor
where is the administrative center of Western NER County	Hurricane_Rita_tornado_outbreak	countycounty	namedfor
who are the descendants of NER's ship name	French_frigate_Cléopâtre_(1781)	shipnamesake	issue
do you know who the person or things that share the same name with NER, a ship, were before?	French_cruiser_Georges_Leygues	shipnamesake	successor
do you know where is the title of Election after NER	Cape_Verdean_parliamentary_election,_2016	afterelection	title
where Does the Religion of Inaugural Speech from NER's Title Come From?	José_Luis_Rodríguez_Zapatero	
which party belongs to The life of The stadium where the NER took place	2010–11_in_Australian_soccer	division	lb
do you know which party belongs to NER ship name	USRC_McLane_(1832)	shipnamesake	religion
what is the time zone used by the NER Southwest Site, an American college basketball season?	2014–15_BYU_Cougars_men's_basketball_team	home	west
do you know who was the Election after NER before	French_legislative_election,_1914	afterelection	title
do you know what time zone is in South of NER, a village in the province of girona and autonomous community of catalonia, spain?	Vall-llobrega	
To which party belongs The name of the ship of NER	USCGC_Dallas_(WHEC-716)	shipnamesake	party
do you know what type of zoning is at the National team location of NER, an estonian association football player?	拉格納·克拉萬	nationalteam	association
do you know where is the city of The location of Birthplace of NER	Junior_Paulo_(rugby_league,_born_1993)	birthplace	cctld
what is the level of management at West of NER's location, a wikimedia listing article?	List_of_National_Cultural_Treasures_in_the_Philippines	provinceprovince	north
who are the NER eponymous affected people	Protagoras_(crater)	eponym	influences
what is the name of the administrative division of the Southeast of NER site	2014–15_Gonzaga_Bulldogs_women's_basketball_team	home	subdivisionname
do you know what is the name of the administrative district of The Northwest Site of NER, an American college basketball season?	2015–16_Utah_State_Aggies_men's_basketball_team	home	subdivisiontype
who is the predecessors of The leader of NER	Dokumacılar	leader	predecessor
what is the level of management at Country Capital to which NER belong	Trujillo_State_Anthem	
what is the level of management at NER's West of Photo Caption, a genus of insects?	Tanaecia	imagecaption	legislature
what is the level of management at NER's North West Site	2011–12_UCLA_Bruins_men's_basketball_team	home	west
