where is the constituency of the one who is alongside NER, a hong kong politician, from?	felix_chung	constituency
who is the successor of the parent of NER, an Irish politician?	francis_russell,_marquess_of_tavistock	parents	successor#0
who is the leader of the administrative region to which NER belongs?	governor_of_genoa	body	leader#1
who preceded the parent of NER, an american economist?	franklin_delano_roosevelt_iii	parents	state#0
which draft team does the author of NER, a 1998 single by shaquille o'neal, dj quik, lord tariq and peter gunz, belong to?	the_way_it's_goin'_down	chronology	team#1	president#1
who is before the parent of NER, an indian lawyer, statesman, and writer, first prime minister of india (1889-1964)?	jawaharlal_nehru	children	before#1	before#1
where does the location province of NER, a mine in mongolia, belong to?	khuut_coal_mine	state/province	seat
who does the origin of NER influence's name?	aryabhata_(crater)	eponym	region	west
what is the genre of the author of NER, a song performed by carlos santana?	they_all_went_to_mexico	chronology	genre#1
which title does the parent of NER, an american economist, belong to?	franklin_delano_roosevelt_iii	parents	title#0
what is the parent mountain of the client of NER?	ira_goldstein	client
who did a job before the parent of NER?	francis_russell,_marquess_of_tavistock	parents	predecessor#1
what is the type of the people, things and things with the same name as NER?	uss_mauna_kea_(ae-22)	title
what is the profession of the one that is after election of NER?	italian_general_election,_1992	afterelection	honorificsuffix
who is the creator of the car that NER is related to?	supergirl_(tv)	company	owner
who is before the commander of NER?	u.s._southern_command	commander	awards
who did a job before the one that is after election of NER?	republic_of_china_presidential_election,_1918	beforeelection
what is spoken by the name included in the NER?	list_of_awards_and_nominations_received_by_craig_david	name	language
who married the author of NER, an album by garth brooks?	christmas_together	chronology	spouse
what is the nationality of the name included in the NER?	list_of_awards_and_nominations_received_by_craig_david	name	nationality
where is the people, things and things with the same name as NER located?	usns_john_lewis_(t-ao-205)	shipnamesake	state
who wrote the singer who performed for NER?	3/8_(album)	extra	studio
which one is known as the prime minister of the one that is after election of NER, a wahl?	peruvian_general_election,_1985	afterelection
where is the team that won NER grounded?	1955–56_hapoel_haifa_f.c._season	stadium#0	tenants	ground
who rules the commander of NER, a middle ages battle?	battle_of_legnano	commander	deathplace
where is the headquarters of the combatant of NER, a civil war?	civil_war_in_the_republic_of_congo	combatant
what is the title of the eponym of NER?	haldane_(lunar_crater)	eponym	title
who is the leader of the combatant of NER?	grief_night	combatant	leader#1
what is the religion of the event happened in NER?	upper_germania	nation	capital
what is the house of the commander of NER?	battle_of_baiteng_river_(938)	place	country	country
where does the one that is after election of NER belong to?	german_federal_election,_1920	afterelection
who is the successor of the leader of NER?	colony_of_greenland_(1950–53)	leader
which dynasty does the leader of NER belong to?	spanish_general_election,_1869	leader	before
what is the job of the people, things and things with the same name as NER?	type_0891a_training_ship	shipnamesake
who starred in the sponsor of NER, a wwe's 2012 night of champions pay-per-views?	night_of_champions_(2012)	sponsor	format
which religion does the country that is affected by NER belong to?	2006_yogyakarta_earthquake	countriesaffected	subdivisiontype
what is the location of the alma mater of NER?	phil_bentley	almamater
what is involved in the important events attended by NER?	2010–11_queens_park_rangers_f.c._season	s	team#1
what does the people, things and things with the same name as NER belong to?	french_ironclad_alma	shipnamesake
what is the succession of the commander of NER?	battle_of_legnano	commander	deathplace
who published the sponsor of NER?	armageddon_(2008)	stip
what belongs to the parent of NER, a mythical character?	neleus	parents	children#2
where is the author of NER, a live album by milt jackson, born?	the_milt_jackson_big_4	chronology
what is the region of the location province of NER?	alderley_edge_mines	state/province	region
what causes the people, things and things with the same name as NER?	greek_destroyer_pindos	shipnamesake
where is the people, things and things with the same name as NER buried?	french_ship_charlemagne_(1852)	shipnamesake	succession#2
which party does the parent of NER belong to?	didit_hediprasetyo	education	timezone
which place is called as the subdivision of the location province of NER?	khökh-adar_mine	country	northwest	legislature
what is on the south of the people, things and things with the same name as NER?	yongfeng-class_coastal_defense_ship	shipnamesake
which war is included in the era of the people, things and things with the same name as NER?	hms_malaya	shipnamesake
who is the leader of NER?	house_of_assembly_of_saint_vincent_and_the_grenadines	leader
who is the regnet of the children of NER, a british politician (1836-1914)?	joseph_chamberlain	children	primeminister	primeminister
who is the descendant of the successor of NER?	leopold_iv,_duke_of_anhalt	issue#1	issue#4
which series does the sponsor of NER, a 2003 world wrestling entertainment pay-per-view event, belong to?	unforgiven_(2003)	event	brands
where is the south of the location province of NER, a mine in russia?	sakhalin_coal_mine	country
who appointed NER's record company?	permanent_mission_of_the_people's_republic_of_china_to_the_united_nations	data
what is the title of the successor of NER?	christoph_(schleswig-holstein)	predecessor	title
what is the party of the one that is after election of NER, a wahl?	united_states_senate_election_in_west_virginia,_2014	afterelection	party
where does the one that is after election of NER get the honorific suffix?	rangitikei_by-election,_1880	afterelection	honorificsuffix
which religion does the one that is after election of NER, a wahl, belong to?	united_states_senate_election_in_nebraska,_2002	afterelection	religion
who did a job before NER related events?	gurjara-pratihara	commonlanguages	nation	west
which war is included in the era of the person whose name is used to name NER?	philolaus_(crater)	eponym	era
who is the manager of the team that won NER?	1968–69_fdgb-pokal	team
who directed the singer who performed for NER?	3/8_(album)	extra	studio
what lies in the west of the county that NER belongs to?	salcombe	shirecounty	west
what is the timezong of NER's southern region?	poboleda	subdivisiontype
who is the prime minister of the parent of NER?	francis_russell,_marquess_of_tavistock	parents	monarch#0
what is the royal house of the person and things that shares the same name with NER?	rv_kronprins_haakon	shipnamesake	royalhouse
what is the status of the country that is spoken NER, a polynesian language related to tuvaluan?	tokelauan	nation	religion
where did the one who is alongside NER, a roman emperor, die?	gordian_i	deathplace
what is the predecessor of the combatant of NER?	irish_civil_war	result
what is the area that the combatant of NER, a civil war, is located in?	civil_war_in_the_republic_of_congo	combatant
who is the predecessor of the coach of NER?	indian_national_football_team	coach
what does the division that NER belongs to work for?	2009–10_in_australian_soccer	division
who is the father of NER-related event related persons?	gurjara-pratihara	event	issue#0
what is the timezong of the northwest of NER?	torres_de_segre	nw	timezone1dst
who is the starring role of the person and things that shares the same name with NER, a 1976 car-shaped submarine from the james bond film the spy who loved me?	wet_nellie	shipnamesake
who married the client of NER?	royal_spring,_warsaw	client
who is the starring role of the theme of NER, a 2016 ride at universal's islands of adventures?	skull_island:_reign_of_kong	theme
what is the parts type of the archipelago that NER belongs to?	milos	archipelago
what is the northeast of the county that NER belongs to?	burgess_hill	shirecounty	northeast
what is the origin of NER's name?	cori_(lunar_crater)	eponym
what is the instrument that the singer who performed for NER, an album by omarion, plays?	ollusion	extra	instrument#0
who leads the people, things and things with the same name as NER?	hms_malaya	shipnamesake	titleleader
what is in the east of the county that NER belongs to?	burgess_hill	shirecounty	east
what is the party of the leader of NER?	provisional_people's_committee_for_north_korea	legislature
where is the birthplace of the coach of NER?	hafez_hashim	coach
what is the location of the person and things that shares the same name with NER?	uss_tutuila_(arg-4)	shipnamesake	location
which country uses the singer of NER, a languages of a geographic region?	languages_of_papua_new_guinea	extra	nation	currencyunit
who gave birth to the person and things that shares the same name with NER?	hms_hecate_(1871)	shipnamesake	parents#1
who is the spouse of the leader of NER?	provisional_people's_committee_for_north_korea	legislature
which royal house does the client of NER, a historical building in corleone, italy, belong to?	royal_palace_of_ficuzza	client	house
which dynasty does the client of NER belong to?	royal_spring,_warsaw	client	title	incumbent
where does the person and things that shares the same name with NER belong to?	uss_winnemucca_(pc-1145)	shipnamesake
who takes the place of the children of NER, a british politician (1836-1914)?	joseph_chamberlain	title
who does the person and things that shares the same name with NER influence?	ms_henrik_ibsen	shipnamesake	influenced#2
what is the currency of the event of NER?	karelian_autonomous_soviet_socialist_republic	commonlanguages#0	minority
which leader party does the location province of NER belong to?	sieberstollen	state/province	leaderparty
who is the commander of the people, things and things with the same name as NER?	french_brig_lodi_(1797)	shipnamesake	commander
where is the client of NER located?	ira_goldstein	client
who is the successor of the car that NER is related to?	sony_xperia_z2a	related	successor	successor
where is the person and things that shares the same name with NER born?	otto_hahn_(ship)	shipnamesake	birthplace#2
what is the language that is commonly used by the combatant of NER?	battle_of_the_tisza	place	governmenttype
which religion does the successor of NER belong to?	jizen_pema	religion
who is the successor of things related to NER?	htc_desire_626	related	successor
which region does NER belong to related events?	archduchy_of_austria	event	result
what happened in the era of the event of NER?	kingdom_of_galicia_and_lodomeria	event#0
who is the most important people of the controller of NER?	brownsea_castle	controlledby	keypeople
which label does the singer who performed for NER, an album by omarion, belong to?	ollusion	extra	label#2
who do the job after the one that is after election of NER?	brazilian_presidential_election,_1960	beforeelection	successor	successor#2
where is the person and things that shares the same name with NER buried?	uss_troup_(1812)	shipnamesake	house	ethnicity
who leads the country that is affected by NER?	1857_basilicata_earthquake	countriesaffected	leader#0	issue#4
what is the country admin division of the person and things that shares the same name with NER?	vaygach_(1989_icebreaker)	shipnamesake	countryadmindivisions
who is the creator of the children of NER?	susan_mayer	children
which state does the one that is after election of NER, a wahl, belong to?	united_states_senate_election_in_west_virginia,_2014	afterelection
what lies in the southeast of the largest city of NER?	mato_grosso	seat	southeast
who takes the place of the coach of NER, a men's national association football team representing india?	indian_national_football_team	coach
which logo is about NER's record company?	i'm__xiao_xiao	label
what is the house of the father of NER?	princess_huaining	father	succession	incumbent
what is the occupation of the leader of NER?	french_legislative_election,_1827	leader
where is the people, things and things with the same name as NER educated?	french_aircraft_carrier_joffre	shipnamesake	education
who is the creator of the author of NER?	it's_a_spongebob_christmas!_album	chronology
who is the leader of the leader of NER, a british politician (born 1967)?	michael_ellis_(british_politician)	leader
which religion does the eponym of NER belong to?	born_(crater)	eponym	religion
where is the birthplace of the commander of NER?	second_rif_damascus_offensive	commander
which language is used in the people, things and things with the same name as NER?	mf_tysnes	shipregistry
where is the birthplace of the father of NER?	dongfu_see_ciqia	father	fatherofwife
what is the rank of the people, things and things with the same name as NER?	german_destroyer_mölders	shipnamesake	rank
who is before the commander of NER, a middle ages battle?	battle_of_legnano	commander	predecessor#0	predecessor
which dynasty does the father of NER belong to?	princess_of_zhongshan_(northern_qi)	father
which timezone does the person and things that shares the same name with NER belong to?	hmcs_wetaskiwin	shipnamesake	timezone
where does the parent of NER belong to?	francis_russell,_marquess_of_tavistock	parents	order#2
where is the alma mater of the people, things and things with the same name as NER?	uss_nitze	shipnamesake	title#1	department
what is the occupation of the one that is after election of NER?	united_states_senate_election_in_north_carolina,_1998	afterelection
who takes the place of the father of NER?	princess_liyang	father
what is the start of the country that is spoken NER?	ongota	states	establishedevent#3
what is the genre of the name included in the NER?	list_of_awards_and_nominations_received_by_billy_ray_cyrus	name	genre#1
which title does the administrative area responsible for NER belong to?	governor_of_genoa	body	titleleader
what is children of the one that is after election of NER, a wahl?	south_korean_presidential_election,_1978	afterelection
whose ancestor is the father of NER, a the king of the goryeo dynasty of korea (955-981),??	gyeongjong_goryeo	father
which title does the bay that NER, an american astronomer, is famous for belong to?	steven_vogt	knownfor
which award is the one who is alongside NER, a japanese general and war criminal, given?	takashi_sakai	office
what is the event of the event happened in NER, a former country?	kingdom_of_galicia_and_lodomeria	event#0
what is the name of the person who influenced the origin of NER's name?	sherrington_(crater)	eponym	almamater#0
which branch does the person and things that shares the same name with NER, a barku den fransia, belong to?	french_cruiser_foch	shipnamesake	branch
what is the status of the cause of NER?	first_battle_of_newtonia	result	status
which language is used in the location province of NER, a silver mine located in the south of argentina in chubut province?	navidad_mine	state/province	language#1
who built the people, things and things with the same name as NER?	osterley_(1780_eic_ship)	shipnamesake
who is the monarch of the person and things that shares the same name with NER, an unit of the canadian forces naval reserve based in ottawa, ontario?	hmcs_carleton	shipnamesake	honorificsuffix
which affiliation does the alma mater of NER belong to?	ed_jackson_(tennessee_politician)	almamater
what is the person and things that shares the same name with NER awarded?	german_cruiser_blücher	shipnamesake	birthplace
which title does the commander of NER belong to?	northeast_autumn_1947_campaign	commander	title#1	appointer
who created the bay that NER is famous for?	claude_garamond	knownfor	creator#0
who leads the event happened in NER?	upper_germania	event	leader#2
what is the deathpalce of the person whose name is used to name NER?	lippershey_(crater)	eponym
what is the series of things related to NER, an android smartphone by sony?	sony_xperia_z3+	series
what is the government type of NER related events?	karelian_autonomous_soviet_socialist_republic	commonlanguages#0
where is the alma mater of NER located?	mark_van_ameyde	almamater
which museum includes the caption of the country that is spoken NER, a language of the baekje kingdom in ancient korea?	baekje	commonlanguages
who is the parent of the parent of NER?	franklin_delano_roosevelt_iii	parents	parents#1
what it the product of the team that won NER, a french motocross rider?	thomas_pagès	otherinterests
who has an important influence on the client of NER?	ramsay_garden	client
which country does the person and things that shares the same name with NER belong to?	uss_nitze	shipnamesake	title#0	department
which region does the bay that NER is famous for belong to?	meyer_amschel_rothschild	religion
what is the origin of NER known for's name?	boltzmann_(crater)	eponym	knownfor#2
what is the person and things that shares the same name with NER, a russian floating nuclear power plant.?	akademik_lomonosov	shipnamesake	workplaces
which mountain range does things related to NER belong to?	axe_(brand)	currentowner
which battle is the people, things and things with the same name as NER involved?	russian_destroyer_marshal_shaposhnikov	shipnamesake	awards
where is the birthplace of the one that is influenced by NER?	bernard_lewis	maininterests
what is the job of the singer who participated in NER?	aim_high_(tv_series)	extra
which religion does the people, things and things with the same name as NER belong to?	usrc_james_madison_(1807)	shipnamesake	religion
which language is commonly used in the person and things that shares the same name with NER?	mohawk_(1781_ship)	shipnamesake	languages#0	fam#1
what started the person and things that shares the same name with NER?	hnoms_otra_(1939)	shipnamesake	commonlanguages
who is the predecessor of the client of NER?	royal_spring,_warsaw	client	predecessor	predecessor
what is the nickname of the alma mater of NER?	paul_bailey_(politician)	almamater
who is the source of the origin of NER's name?	penticton_(crater)	eponym	subdivisionname
who is the consort of the people, things and things with the same name as NER?	hms_ariadne_(1816)	shipnamesake
where does the event of NER take place?	empire_of_china_(1915–16)	event
which type does the country that is spoken NER belong to?	jincheng_dialect	states	postalcodetype
which event establishes the country of birth of NER?	igor_cvitanovic	countryofbirth	southwest
which school does the artist who sings for NER belong to?	tokyo_juliet_(tv_series)	extra#0
who created the theme of NER?	skull_island:_reign_of_kong	theme
which title does the cause of NER, a battle, belong to?	battle_of_bedriacum	result
who is the female parent of the person and things that shares the same name with NER?	mv_prins_harald	shipnamesake
what is the format of the notable work of NER, an american broadcaster and journalist?	aleks_krotoski	notableworks	format
what is the legislature of the country of birth of NER?	igor_cvitanovic	countryofbirth	legislature
which house does the event of NER, an indian dynasty that ruled much of northern india from the mid-8th century to the 11th century, belong to?	gurjara-pratihara	commonlanguages
what is the work place of the people who influence NER?	alexander_rich	influences	workplaces#1
who is the predecessor of the leader of NER?	united_kingdom_general_election,_1886_(ireland)	leader
what is the instrument that the name included in the NER, a wikimedia list article, plays?	list_of_awards_and_nominations_received_by_jessica_simpson	name	instrument
who is the director of the theme of NER?	skull_island:_reign_of_kong	designer
which label does NER belong to related events?	uefa_women's_euro_2013_final	event
what is the cause of the event involved in NER?	archduchy_of_austria	event	result
when is the author of NER born?	can_i_borrow_a_dollar%3f	chronology
which league does the team that won NER belong to?	1923–24_atromitos_f.c._season	team
who is the spouse of the parent of NER?	buhe_(politician)	parents	predecessor	premier
which team takes part in the author of NER, a 1998 single by shaquille o'neal, dj quik, lord tariq and peter gunz?	the_way_it's_goin'_down	chronology
where did the combatant of NER die?	battle_of_que_mountain	combatant	deathplace#1
who directed the team that won NER?	red_bull_rb12	team	director
which title does the client of NER own?	royal_spring,_warsaw	client	title
which language does the singer who performed for NER use?	boysitter	firstrun	legislature
who makes the law of the cause of NER, a battle of the american civil war?	first_battle_of_newtonia	result	legislature
who is before the father of NER?	princess_of_qingdu	father
who is the successor of the people, things and things with the same name as NER?	warren_hastings_(1802_eic_ship)	shipnamesake	successor
who honored the children of NER?	anwar	honorificsuffix
who is the successor of the one who is alongside NER, a roman emperor (201-251)?	decius	successor
what is the occupation of the author of NER?	lovers_(cannonball_adderley_album)	chronology
where does the one that is after election of NER, an election in minnesota, belong to?	united_states_presidential_election_in_minnesota,_1968	afterelection	president
what is the title of the children of NER?	women's_day	children	title
who is the predecessor of the people, things and things with the same name as NER?	uss_charles_f._hughes_(dd-428)	shipnamesake	after	before
who married the eponym of NER?	cori_(lunar_crater)	eponym
what is the subdivision name of the people, things and things with the same name as NER?	hmcs_kamloops	shipnamesake	subdivisionname#0	label#7
who is the chairman of the sponsor of NER?	summerslam_(1994)	sponsor	chairman
where is the combatant of NER born?	battle_of_que_mountain	combatant	birthplace#1
where did the origin of NER study's name?	nagaoka_(crater)	eponym
which affiliation does the alma mater of NER belong to?	frank_darling_(architect)	almamater
who is the spouse of the one that is after election of NER?	german_presidential_election,_1994	afterelection	spouse#1
what is the author of NER?	unbreakable_(janet_jackson_album)	chronology	profession#1
what is the branch that the parent of NER, an indonesian socialite, belongs to?	didit_hediprasetyo	education	southwest
which timezone does the team that won NER, a volleyball player, belong to?	liset_herrera	team	timezone
which dynasty is the leader of NER, an a mostly dhulbahante state based in the khatumo region which opposed imperialism that existed from the years 1896 until 1921, born?	dervish_state	commonlanguages
what is the timezong of the people, things and things with the same name as NER?	hmcs_parry_sound	shipnamesake	timezonedst
what is the location country of the client of NER?	warner_elevator_row	client
who is issued by NER related events?	gurjara-pratihara	event
what is the warrior of the person and things that shares the same name with NER?	sas_isandlwana_(f146)	shipnamesake
which is the capital of the location province of NER?	salinas_grandes_mine	state/province	capital
who is the successor of the successor of NER?	ferdinand_philippe,_duke_of_orléans	successor
which house does the person and things that shares the same name with NER belong to?	hms_black_prince_(81)	shipnamesake
what is the electoral district of the sponsor of NER?	stafford_150	sponsor	constituencywestminster
where does the people, things and things with the same name as NER take place?	french_ship_rivoli_(1810)	shipnamesake	place#0
which party does the people, things and things with the same name as NER belong to?	usrc_bibb_(1843)	shipnamesake	party
which place is called as the subdivision of the city in the south of NER?	vall-llobrega	s
which national team does NER's coach belong to?	seattle_sounders_fc_2	s
who is influenced by the name included in the NER?	empedocles_(volcano)	type
which title does the nickname of NER belong to?	si_xi	nickname	title#2
which team won the coach of NER, an american professional basketball team?	brooklyn_nets	affiliation
who did a job before the person and things that shares the same name with NER?	uss_windom_(1896)	shipnamesake	after#1	after
which religion does the leader of NER believe?	united_states_of_indonesia	deputy
what is the address of the person whose name is used to name NER	cori_(lunar_crater)	eponym
which country does the person whose name is used to name NER, a crater on mercury, belong to?	mendes_pinto_(crater)	eponym
who is the founder of the person and things that shares the same name with NER?	soviet_cruiser_komintern	shipnamesake	ideology#0
where did the one that is after election of NER study?	united_states_senate_election_in_north_carolina,_1998	afterelection
which country does the theme of NER belong to?	the_wizarding_world_of_harry_potter_(universal_studios_japan)	theme	country
what is the largest city of the person and things that shares the same name with NER, a brazilian warship?	brazilian_monitor_alagoas	shipnamesake	largestcity
what kind of company is the sponsor of NER?	vodacom_cup	sponsor	companytype
who is issued by the people, things and things with the same name as NER?	rms_queen_mary_2	shipnamesake	issue#0
which province does the alma mater of NER belong to?	amy_jephta	almamater	provinceprovince
what does the status of the people, things and things with the same name as NER belong to?	hms_montserrat_(k586)	shipnamesake	status
what is the map caption of the people, things and things with the same name as NER?	french_ship_polyphème_(1815)	shipnamesake
what is the type of NER's related products?	kinder_joy	related	type
which country does the alma mater of NER belong to?	shin_chang-jae	almamater
what is the alma mater of the one that is influenced by NER?	alain_badiou	maininterests
which label does the author of NER work for?	the_milt_jackson_big_4	chronology
what is the leader title of the location province of NER, a copper mine in papua new guinea (bougainville island)?	panguna_mine	country	politicalsystem
what is the region of the person and things that shares the same name with NER?	uss_platte_(ao-186)	shipnamesake
what is the office of the one that is after election of NER?	northern_cyprus_presidential_election,_2015	afterelection
which currency is used in the person and things that shares the same name with NER, an a colony-class frigate of the united kingdom that served during world war ii?	hms_nyasaland_(k587)	shipnamesake	currency
who makes the law of the location country of NER?	bled_castle	locationcountry	legislature
what is the religion of the man who influenced NER?	giuseppe_garibaldi	honorificprefix
which country does the one that is after election of NER belong to?	united_states_senate_election_in_north_carolina,_1990	afterelection
who founded the controller of NER?	brownsea_castle	controlledby	founder
who is the director of the person and things that shares the same name with NER?	wet_nellie	shipnamesake	studio
which type of government does the person and things that shares the same name with NER belong to?	hmcs_sherbrooke	shipnamesake	governmenttype
which one is presented before the person and things that shares the same name with NER, a 1976 car-shaped submarine from the james bond film the spy who loved me?	wet_nellie	shipnamesake
who gives the honorific suffix of the parent of NER, an Irish politician?	francis_russell,_marquess_of_tavistock	parents	honorificsuffix#1
what is the person whose name is used to name NER?	cavendish_(crater)	eponym	workinstitutions
what is the title of the leader of NER, an eleccions generals d'espanya?	spanish_general_election,_1869	leader	title
who did a job before the author of NER?	the_way_it's_goin'_down	chronology	after#1
where is the birthplace of the leader of NER?	classical_athens	legislature
what is originated from the people, things and things with the same name as NER, an abdiel-class minelayer?	hms_apollo_(m01)	shipnamesake
who is the spouse of the people, things and things with the same name as NER?	french_ship_alexandre_(1857)	shipnamesake	succession
who takes the place of the commander of NER, a battle of the american revolutionary war?	battle_of_long_point	commander
what is the constituency of the person and things that shares the same name with NER?	usns_harvey_milk_(t-ao-206)	shipnamesake	constituency#1
which religion does the administrative area responsible for NER belong to?	governor_of_genoa	body	religion
who is before the nickname of NER?	si_xi	nickname	before
who does the people, things and things with the same name as NER, a historical french ship, influence?	french_frigate_descartes	shipnamesake	almamater
what is the era of the cause of NER?	first_battle_of_newtonia	result	era#0
what is the genre of the theme of NER, an area in universal studios japan?	the_wizarding_world_of_harry_potter_(universal_studios_japan)	theme	genre#1
who is the predecessor of the car that NER is related to?	htc_one_x9	related	predecessor#1	predecessor
who is the predecessor of the one that is after election of NER?/ who is the father of the one that is after election of NER?	italian_general_election,_1874	afterelection
who is the predecessor of the client of NER, a historical building in corleone, italy?	royal_palace_of_ficuzza	client
who is the predecessor of the leader of NER, an eleccions generals d'espanya?/ who is the father of the leader of NER, an eleccions generals d'espanya?	spanish_general_election,_1869	leader	before
what is spoken by the leader of NER?	dervish_state	commonlanguages
what is the club that NER's head coach belongs to?	seattle_sounders_fc_2	s
what is the style of the father of NER, a chinese martial artist and physician?	wong_fei_hung	father
what is the title leader of the cause of NER?	first_battle_of_newtonia	result	titleleader
which type of subdivision does the people, things and things with the same name as NER, a ship of the royal canadian navy, belong to?	hmcs_peterborough	shipnamesake	subdivisiontype#2
which office does the leader of NER, a Spanish politician, belong to?	miguel_primo_de_rivera_y_sáenz_de_heredia	leader
who is the next the father of NER?	heshuo_hehui_princess	father
who commanded the name included in the NER?	germanic_wars	name
who is the male parent of the client of NER?	royal_spring,_warsaw	client
who is the successor of the father of NER?	princess_of_qingdu	father
who is the successor of the parent of NER, an american economist?	franklin_delano_roosevelt_iii	parents	after#1
who is the successor of the leader of NER?	duchy_of_anhalt	leader#1
who is the creator of the notable work of NER?	sarah_natochenny	notableworks	creator
where is the constituency of the one that is after election of NER from?	taiwan_legislative_election,_1995	afterelection	honorificsuffix
who takes the place of the cause of NER, a 1106 battle during the invasion of normandy by henry i?	battle_of_tanshebrai	commander#1	before
who is the deputy of the combatant of NER?	grief_night	combatant	deputy#1
who takes the place of the war that happened in the era of NER?	united_netherlands_sovereign_duchy	era
which country does the one that is after election of NER belong to?	colombian_presidential_election,_1986	afterelection
what is the common language of the area of NER related events?	kingdom_of_galicia_and_lodomeria	event#0	commonlanguages
what is the leader name of the person and things that shares the same name with NER?	hms_montserrat_(k586)	shipnamesake
what is the nationality of the one that is after election of NER?	civic_democratic_party_leadership_election,_1997	afterelection
where is the people, things and things with the same name as NER located?	french_battleship_carnot	shipnamesake
which event happened in the person and things that shares the same name with NER?	hms_malaya	shipnamesake
who is the mother of the client of NER?	royal_palace_of_ficuzza	client
what is the type of the archipelago that NER belongs to?	milos	archipelago	type
which battle does the controller of NER take part in?	ins_trata	controlledby	battles
which label does the country that is spoken NER, a language, have?	ongota	states	label#11
what is the event of the cause of NER?	first_battle_of_newtonia	result	event#0
what is the allegiance of the person and things that shares the same name with NER, a barku, to?	css_stonewall_jackson	shipnamesake	allegiance#0
which dynasty does the successor of NER live in?	belengalia_(castile)	predecessor	house
who is the successor of the cause of NER?	battle_of_bedriacum	result	placeofdeath	leadername
what is the type of the bay that NER is famous for?	john_pemberton	knownfor	type
who is the predecessor of the one who is alongside NER?	felix_chung	predecessor#1
who is the predecessor of the children of NER, a british politician (1836-1914)?	joseph_chamberlain	title
what is the region of the chief town of NER?	canton_of_liévin-sud	chieftown
which timezone does the city in the south of NER, a municipality in noguera, ponent, lleida province, spain, belong to?	montgai	nw	timezone1dst
what is the rank of the one that is after election of NER?	guatemalan_general_election,_2011	afterelection	title
who did a job before NER-related products+?	sony_xperia_z3	after	after
where is the location province of NER, a bergwerk in senegal, seated?	falémé_mine	state/province
where is the capital of the person and things that shares the same name with NER located?	hms_st._helena_(k590)	shipnamesake	establishedevent#2
what is the allegiance of the one who is alongside NER to?	takashi_sakai	almamater
where did the leader of NER, a state, die?	government_of_national_salvation	era
which bay lies in the southwest of the country of birth of NER?	igor_cvitanovic	countryofbirth	southwest
what is the title of the car that NER, a television series, is related to?	invincible_intelligence_agent	related
which branch does the one that is after election of NER belong to?	thai_general_election,_1996	afterelection
what is the title of the war that happened in the era of NER?	united_netherlands_sovereign_duchy	era
who owns the sponsor of NER?	old_newton_cup	sponsor	locationcity
what includes the event of NER, an isolated human group?	tanukhids	region
which type does the location province of NER belong to?	kallazhagar_temple	state/province	type#0
who is the producer of the person and things that shares the same name with NER?	wet_nellie	shipnamesake	studio
which battle is the one that is after election of NER, a wahl, involved?	south_korean_presidential_election,_1980	afterelection
which type of post code does the people, things and things with the same name as NER belong to?	uss_winnemucca_(pc-1145)	shipnamesake
what is the office of the one who is alongside NER?	hyon_yong-chol	alongside	1namedata	branch
where did the people, things and things with the same name as NER die?	french_cruiser_foch	shipnamesake	birthplace#1	establishedevent
who founded the sponsor of NER, a female adopted child?	adopted_daughter	sponsor
what is the origin of the name included in the NER?	list_of_awards_and_nominations_received_by_bunga_citra_lestari	name
when is the one that is after election of NER born?	belizean_general_election,_1984	afterelection	placeofbirth#0
who is earlier than the author of NER?	the_way_it's_goin'_down	chronology	before#1
who is the mother of the leader of NER?	albanian_kingdom_(1928–39)	religion#0
which place is called as the subdivision of the chief town of NER, a canton of france?	canton_of_nemours	chieftown	subdivisionname#1
who makes the law of the location province of NER?	pyrkakay_mine	country	legislature
what is the title leader of NER related events?	kingdom_of_galicia_and_lodomeria	event#0	titleleader
what does the leader of NER succeed?	albanian_kingdom_(1928–39)	commonlanguages
who gives the honorific suffix of the commander of NER?	battle_of_long_point	commander	awards
what does the chief town of NER, a canton of france (until march 2015), belong to?	canton_of_montreuil	chieftown
who is the predecessor of the successor of NER?	belengalia_(castile)	predecessor
who takes the place of the successor of NER?	ügyek	issue#1
which timezone does the location province of NER belong to?	selkirk_mine	state/province	seat
where is the city in the south of NER seated?	garrigues_(comarca)	seat
who is the most important people of the sponsor of NER?	telstra_phonewords_stakes	sponsor	keypeople#1
which timezone does the northwest of NER belong to?	tornabous	nw	timezone1dst
who is the leader of the parliament of seats held by NER?	indonesian_militant_democratic_party	chairman
who takes the place of the commander of NER?	battle_of_legnano	commander	successor
what is the warrior of the name included in the NER?	germanic_wars	name
who manufactured things related to NER?	nokia_e5-00	related	manufacturer
what is the title of the person and things that shares the same name with NER, an ironclad warship of the greek navy?	greek_ironclad_vasilefs_georgios	shipnamesake	issue
what is the allegiance of the leader of NER to?	classical_athens	event#0
what is the type of the alma mater of NER?	greg_gard	sport
who is the incumbent of the leader of NER?	community_of_saint_anselm	leader	incumbent
what is the succession of the successor of NER?	ferdinand_philippe,_duke_of_orléans	succession
what is the singer who participated in NER, an album by omarion?	ollusion	extra	instrument#0
what does the country admin division of the archipelago that NER belongs to belong to?	new_britain_island	location
what is the alma mater of the man who influenced NER?	giuseppe_garibaldi	influences	religion#0
who is the premier of the commander of NER?	northeast_autumn_1947_campaign	commander	premier
who is the coach of the team that won NER, a 18th season for the orlando magic?	2006–07_orlando_magic_season	team	coach
which genre does the singer of NER belong to?	i'm_so_sorry	format
what does the person and things that shares the same name with NER end up in?	hms_malaya	shipnamesake	commonlanguages
who is the prime minister of the leader of NER, a parlamento di saint vincent e grenadine?	house_of_assembly_of_saint_vincent_and_the_grenadines	leader	primeminister
what is the profession of the leader of NER?	french_regional_elections,_2015	leader	profession
where is the stadium of the important event of NER, a season of football team, held?	2010–11_queens_park_rangers_f.c._season	stadium
which instrument does the author of NER play?	identity_(zee_album)	chronology	instrument#4
what is the nationality of the people, things and things with the same name as NER?	type_0891a_training_ship	shipnamesake	nationality
who is the predecessor of the one that is after election of NER?	french_legislative_election,_1893	afterelection
which dynasty does the cause of NER live in?	battle_of_tanshebrai	partof
what lies in the northwest of the county that NER belongs to?	burgess_hill	south
who makes the law of the person and things that shares the same name with NER?	hms_montserrat_(k586)	shipnamesake	legislature
which party does the NER-held parliament belong to?	indonesian_militant_democratic_party	seats1title
what is the person and things that shares the same name with NER known for?	french_submarine_joule	shipnamesake
which office does the person and things that shares the same name with NER belong to?	sms_hindenburg	shipnamesake	office
what is the combatant of the event of NER?	fețele_albe_dacian_fortress	event
where did the leader of NER study?	united_kingdom_general_election,_1886_(ireland)	leader	honorificprefix
how to address the commander of NER?	battle_of_varese	partof	partof
what is the southwest of the location province of NER, a mine in russia?	sakhalin_coal_mine	country	capital
which country does the country that is affected by NER belong to?	1857_basilicata_earthquake	countriesaffected	country	currencyunit
who is the predecessor of the leader of NER, a british politician (born 1967)?	michael_ellis_(british_politician)	leader	before#1
who is the successor of the client of NER?	royal_palace_of_ficuzza	client
who is the descendant of the commander of NER?	the_battle_of_dingtao_(eastern_han_dynasty)	commander
which genre does the person and things that shares the same name with NER belong to?	ms_henrik_ibsen	shipnamesake	genre
who takes the place of the car that NER is related to?	sony_xperia_t	successor
what it the product of the sponsor of NER, a horse race?	black_opal_stakes	sponsor	products#0
where is the birthplace of the one that is after election of NER, a wahl?	colombian_presidential_election,_1998	afterelection
which place is called as the subdivision of the northwest of NER?	arbúcies	n	e
which city does the people, things and things with the same name as NER belong to?	uss_platte_(ao-186)	shipnamesake
who starred in the works that make NER known?	khalid_siddiqui	notableworks
which dynasty is the person whose name is used to name NER born?	haldane_(lunar_crater)	eponym	education
what is the title of the father of NER?	princess_yongan_(tang_xianzong)	identity	title
who is the predecessor of the children of NER?	joseph_chamberlain	children	predecessor
which program is before NER's famous works?	hiro_fujiwara	notableworks	studio
what is connected with the person and things that shares the same name with NER?	uss_hopi_(at-71)	shipnamesake	related#1
what is the name of the one that is after election of NER?	united_malays_national_organisation_leadership_election,_2009	afterelection
where did the commander of NER, an an offense by mahdist forces against british and egyptian troops, die?	siege_of_khartoum	commander
which award is the person whose name is used to name NER given?	meitner_(venusian_crater)	eponym	ethnicity
what is the origin of the author of NER?	parachilna_(album)	chronology
where does the leader of NER belong to?	united_kingdom_general_election,_1886_(ireland)	leader	honorificprefix
what is the status of the combatant of NER?	battle_of_chiayi	combatant	commonlanguages
what is the type of the sponsor of NER?	waterstones_11	location	languages	ethnicity
who is the father of the leader of NER?	yue_(state)	religion
who married the author of NER, a single?	someone_put_your_hand_out_(michael_jackson_song)	chronology	spouse#1
what is the postal code type of the country that is spoken NER?	jincheng_dialect	states	language
where did the one that is after election of NER, a wahl, die?	haitian_presidential_referendum,_1961	afterelection
which dynasty is the person and things that shares the same name with NER born?	uss_schley_(dd-103)	shipnamesake
what is the source of information of the combatant of NER?	battle_of_bangorach	combatant
what is the southwest of the location country of NER?	bled_castle	locationcountry	southwest
which industry is the team that won NER, an american long-distance runner, from?	natosha_rogers	team	industry
which national team does the name included in the NER, a national association football team, belong to?	brunei_national_under-21_football_team	name	nationalteam#2	location#2
which sport does NER's coach play?	2014–15_sc_freiburg_season	location#2
what is the province of the client of NER?	ludvika_town_hall	client
what is the common language of the country of birth of NER, a congolese footballer?	gabriel_sacuiani	countryofbirth	commonlanguages#0
who is the owner of the team that won NER?	red_bull_rb12	team	owner
what is in the charge of the person and things that shares the same name with NER?	uss_carl_m._levin	shipnamesake	order#0
what is the name included in the NER?	list_of_awards_and_nominations_received_by_billy_ray_cyrus	name
what is the profession of the person and things that shares the same name with NER, an arleigh burke-class destroyer?	uss_carl_m._levin	shipnamesake	order#1
which war is included in the era of the name included in the NER?	empedocles_(volcano)	type
which genre does the sponsor of NER, a 2009 world wrestling entertainment pay-per-view event, belong to?	wwe_breaking_point	sponsor	genre
where does the one that is after election of NER live?	peruvian_general_election,_1985	afterelection
what is the subdivision rank of the person and things that shares the same name with NER?	marsouin_(1788_ship)	shipnamesake	subdivisionranks
who is the leader of the country that is spoken NER, a language of the baekje kingdom in ancient korea?	baekje	commonlanguages
where is the eponym of NER born?	hevelius_(crater)	eponym	religion
who is the one that is after election of NER?	romanian_general_election,_1922	afterelection
who is the last of the commander of NER?	the_battle_of_dingtao_(eastern_han_dynasty)	commander	regent
what is the canton of the northwest of NER?	amiens	w	canton
which language is commonly used in the people, things and things with the same name as NER, a 1915 queen elizabeth-class battleship of the royal navy?	hms_malaya	shipnamesake	commonlanguages
who gives the honorific suffix of the people, things and things with the same name as NER?	hms_bligh_(k467)	shipnamesake
where does the bay that NER is famous for come from?	meyer_amschel_rothschild	religion
what kind of company is NER-related products?	wingnut_films	related	companytype
where is the people, things and things with the same name as NER?	uss_tutuila_(arg-4)	shipnamesake	location
who is the consort of the name included in the NER?	hades_in_popular_culture	name
what is the type of the origin of NER's name?	bolsena_lacus	eponym	type
who is the founder of NER's record company?	destiny_(game)	label	founders#0
what is the name included in the NER, a wikimedia list article?	list_of_awards_and_nominations_received_by_craig_david	name
which title does the event happened in NER, a former country, belong to?	kingdom_of_galicia_and_lodomeria	event#0	titleleader	appointer
where is the archipelago that NER belongs to located?	fairy_shoal	archipelago	location
which event establishes the location country of NER?	bled_castle	locationcountry	southwest
who is the descendant of the cause of NER?	battle_of_tanshebrai	commander#1
who married the father of NER?	goryeo_kwangjong	father
which country does the person and things that shares the same name with NER, a ship, belong to?	french_battleship_danton	shipnamesake	title
what is the ethnicity of the people, things and things with the same name as NER?	mv_yulius_fuchik	shipnamesake
which religion does the father of NER belong to?	elihia	father	religion
which religion does the country of birth of NER, an Algerian footballer, belong to?	rhones_garvay	cityofbirth	timezone
who is the director of NER's famous works?	khalid_siddiqui	notableworks
which industry is the sponsor of NER from?	telstra_phonewords_stakes	sponsor	industry
who is the predecessor of the client of NER?/ who is the father of the client of NER?	royal_palace_of_ficuzza	client
what is the typical subdivision of the northwest of NER, a municipality in the comarca of osona in catalonia, spain?	gurb	timezone1dst
what is the province of the people, things and things with the same name as NER?	italian_cruiser_vittorio_veneto	shipnamesake	provinceprovince
what is birth place of the successor of NER?	ramiro_i_of_asturias	placeofbirth
where does the leader of NER get the honorific suffix?	london_local_elections,_2018	leader
who is the next the cause of NER?	battle_of_tanshebrai	partof
who is earlier than the person and things that shares the same name with NER?	cornwallis_(1787_ship)	shipnamesake	honorificprefix
which country does the alma mater of NER belong to?	edward_mcalexander	almamater	country
which company lies in the east of the largest city of NER?	mato_grosso	seat
what does the people, things and things with the same name as NER succeed?	leopoldus_primus	shipnamesake	house#0
who is the extra of the car that NER is related to?	happy_family	related
what is the burial place of the client of NER?	royal_spring,_warsaw	client
which religion does the combatant of NER belong to?	grief_night	combatant	religion
what is the nationality of the leader of NER?	french_national_convention_election,_1792	afterelection
who is the spouse of the one who is alongside NER?	dong_biwu	premier
what is the deathpalce of the person and things that shares the same name with NER?	sas_president_kruger_(f150)	shipnamesake	placeofdeath#0
who is the father of the people, things and things with the same name as NER?	maud_(ship)	shipnamesake	father
who does the sponsor of NER work for?	palm_of_jerusalem	sponsor	author
which mountain range does the sponsor of NER belong to?	2011_penrith_panthers_season	name	birthplace#1
who is the parent of the children of NER?	anwar	almamater
where did the eponym of NER die?	eijkman_(crater)	eponym
which city does the alma mater of NER belong to?	cleo_baldon	almamater	state	capital
who is the commander of the controller of NER?	ins_trata	controlledby	commander#1
where is the event of NER located?	kingdom_of_galicia_and_lodomeria	event#0
who is the director of the sponsor of NER?	night_of_champions_(2012)	sponsor
where is the capital of the location of NER located related events?	first_hungarian_republic	event	capital
who starred in the singer who performed for NER?	3/8_(album)	extra
which place is called as the subdivision of the southeast of the south of NER?	new_harmony,_utah	subdivisionname#1
what is the name of the chairman of the incumbent of the title of NER?	khamtai_siphandon	successor
what is in the charge of the successor of the candidate of NER?	constituency_election_results_in_the_united_kingdom_general_election,_1923	candidate#1
what is the start of the location of the national team that NER belongs to?	rad_bogdanovic	clubs#2
what is the religion of the location of the national team that NER, a hong kong association football player, belongs to?	peng_zijian	nationalteam	location#2
what is the subdivision type of the north of the northeast of NER, a town in garfield county, utah, united states?	antimony,_utah	subdivisiontype#1
what is the timezong of the east of the south of NER?	wales,_utah	timezonedst
what is the timezong of the east of the south of NER, a town sanpete county, utah, united states?	wales,_utah	timezonedst
which timezone does the north of the west of NER belong to?	oude_ijsselstreek	postalcodetype
where is the alma mater of the successor of the candidate of NER?	french_regional_elections,_2010	candidate#2
what is the deathpalce of the successor of the descendant of NER?	mary_of_hungary,_queen_of_naples	succession
what is the subdivision name of the northeast of the southeast of NER?	fillmore,_utah	subdivisionname#0
which country does the predecessor of the premier of NER, a taiwanese politician, former president of the republic of china, belong to?	ma_ying-jeou	president	before
who is the female parent of the successor of the descendant of NER?	bonne_of_bohemia	issue#1	succession
which type of subdivision does the southeast of the southwest of NER, a city in summit county, utah, united states, belong to?	kamas,_utah	subdivisiontype#2
who did a job before the predecessor of the candidate of NER?	neath_(uk_parliament_constituency)	candidate#1	predecessor
what is the timezong of the west of the location of NER?	2013–14_copa_catalunya	location#5	w
who do the job after the successor of the children of NER?	sobekemsaf_ii	children#0	successor	next
which dynasty does the legislature of the state party of NER belong to?	prehistoric_pile_dwellings_around_lake_zurich	stateparty#0	legislature
who did a job before the first the title of NER?	duncan_mcnabb	title#1	first
town in Dudgett County, Utah, United States, the location in the south of NER, the location in the southwest, which division belongs to	manila,_utah	south#0	timezonedst
what type of person or thing with the same name as NER	uss_mauna_kea_(ae-22)	title
who is affected by the person, thing, or thing with the same name as NER?	french_frigate_descartes	shipnamesake
what is the zoning of the location in the south of the city where NER is located?	national_register_of_historic_places_listings_in_montana	county#0
what is the area of the location in the northwest of the city where NER is located?	national_register_of_historic_places_listings_in_minnehaha_county,_south_dakota	city#0
who is the successor of NER's election winner?	italian_general_election,_1992	beforeelection	successor
what is the zoning of the location in the north of NER?	france_at_the_2015_world_speed_skating_championships	location#1	caption
who is the last of the title of NER?	zhu_de	before
where was the first person with the title of NER born?	shahabuddin_ahmed	title#2	residence#0
A town in Pinnacle County, Utah, USA, what is the area of NER, the location in the southwest, and the location in the north?	francis,_utah	subdivisionname#0
what is the country region of the location in the northern part of the province where NER is located?	list_of_cultural_properties_of_the_philippines_in_cagayan_valley	province#0
NER, the 1991 edition of the FIFA Women's World Cup, what is the title of the venue leader in the northeast of its host	1991_fifa_women's_world_cup	stadium#0	northeast
what event is the person or thing with the same name as NER	french_ship_wagram_(1854)	shipnamesake	partof
what is the occupation of the singer who participated in NER?	that_winter,_the_wind_blows	extra
what is the religion of the origin of the name NER?	aryabhata_(crater)	eponym	region	capital
where the person whose name is used to name NER was born	fabry_(crater)	eponym	birthplace
who is the predecessor of the person, thing, and thing with the same name as the Hamburg escort NER?	leopoldus_primus	shipnamesake	predecessor#0
NER, Wikimedia listing article, what team is the captain of its club location	2009_fifa_u-17_world_cup_squads	club#0
what time zone does the location in the east of NER belong to?	huntington,_utah	timezonedst
what is the division of the location in the southwest of NER's city?	list_of_closed_railway_stations_in_ireland	county#2
what is the title of NER's election winner	brazilian_presidential_election,_1969	afterelection	predecessor	appointer
what party does NER's namesake belong to?	usrc_ingham_(1832)	shipnamesake	party#1
what area does NER's southern region belong to?	prat_de_comte	s
where is the location of the location in the east, where the NER is held for a season of French football clubs	2009–10_olympique_de_marseille_season	stadium#3
and NER, a ship, what is the area to which the person or thing with the same name belongs	sms_zenta	shipnamesake	subdivisionname#0	legislature
what state is NER's alma mater in?	joanne_grant	almamater	state
who led the legislature where NER died	vasili_yanchenko	deathplace#1	legislature
what type of company is the owner of a NER club location?	2009_world_baseball_classic_rosters	club#0
who is the current incumbent of the title of NER?	wen_jiabao	1namedata
French politician (1885-1956) who was the predecessor of the previous generation of NER	yvon_delbos	before#1
where is the address of NER related events	empire_of_china_(1915–16)	event
what is the name of the mother of the ruler of the descendants of NER?	princess_maria_pia_of_bourbon-two_sicilies_(1849–1882)	issue#0	regent	mother
what is the nickname of NER's alma mater?	mark_van_ameyde	almamater
who leads the legislature where NER is used	renault_ft	usedby#1	legislature
what products do NER's sponsors have	telstra_phonewords_stakes	sponsor	products#0
NER's location what time zone does the city in the west belong to?	2013–14_gimnàstic_de_tarragona_season	location#1
which city is the operator of NER's location?	2008–09_torquay_united_f.c._season	location#1
what is the origin of the name of NER?	hmcs_vimy	shipnamesake	result
The name of the location leader of the Eastern location of the NER location for a season of the football team is	2015_beijing_guoan_f.c._season	stadium#0
NER, British politician (born 1967) who is its leader	michael_ellis_(british_politician)	leader
A town in Millard County, Utah, United States what is the time zone of the location in the southeast of NER, the location in the northeast?	meadow,_utah	timezonedst
what is the famous work of the person named NER?	maclaurin_(crater)	eponym	workplaces#0	country#0
NER's election winner who's successor	united_states_senate_election_in_vermont,_1980	afterelection	state
who is the successor of NER's election winner?	democratic_party_(hk)_leadership_election,_2002	afterelection
what time zone is used in the southern region of NER?	massalcoreig	subdivisiontype
which district does the city in the west of the birthplace of SS officer NER belong to?	adolf_ax	birthplace#1	legislature
where are NER related events held?	uefa_euro_1980_final	event	stadium
where is the birthplace of people, things and things with the same name as NER?	president_el_hadj_omar_bongo_(ship,_1978)	shipnamesake
who is the leader of the legislature where the French light tank NER of 1936 was used	hotchkiss_h35	usedby#1	legislature
NER, the early dynastic confederation of ancient Egypt (c. 3150 AD) whose leader was the last	thinite_confederacy	leader	successor	prev
NER, Wikimedia list article, what are the titles of the leaders of the locations south of the city where they are located	national_register_of_historic_places_listings_in_snohomish_county,_washington	city#2	south
NER's election winner who's successor	german_presidential_election,_2009	afterelection
what classification level does the person or thing with the same name as NER belong to?	uscgc_clover_(wlb-292)	shipnamesake	subdivisionranks
what is the zoning of the area to the northwest of NER, a village in the province of Girona, Catalonia, Spain	arbúcies	n	e
which film company does NER's related products (works) belong to?	shark_(2013_tv_series)	previousshow	network
who are the people influenced by the people in NER?	empedocles_(volcano)	type
what dynasty does NER's name belong to?	spanish_frigate_reina_sofía	shipnamesake	house#1
NER, Vancouver Whitecaps football season, what is the zoning of the location west of its location	2005_vancouver_whitecaps_fc_season	location#1	blankname
what is the division of the administrative center of the father of NER, a mountain range in southeastern Poland	pogórze_bukowskie	parent#1	seat	timezonedst
what is the time zone of the location north of the international football match NER?	2015_international_champions_cup	stadium#3
who is NER's child with the same name	hms_apollo_(m01)	shipnamesake	parents#0
Who's the previous election winner for Wall NER?	united_states_senate_election_in_north_carolina,_1990	afterelection
what party is the election winner for Wall NER?	south_african_general_election,_1977	afterelection
where NER's election winner was born	lithuanian_parliamentary_election,_2000	afterelection
NER, a waterfall, what is the name of the leader of its province	dhua_kund	state/province	south
what is the title of the consort of the ruler of NER	saliha_dilaşub_sultan	issue	title#1
Wikimedia listing article NER location what is the title of the location leader in the west	major_national_historical_and_cultural_sites_(guangdong)	location#2
NER's location what time zone does the northern location belong to?	south_carolina_highway_151	location#0	timezonedst
In a French state (as of March 2015) which district is the main town of NER	canton_of_neuilly-saint-front	chieftown
what time zone is the location in the southeast of the city where the Wikimedia list article NER is located	national_register_of_historic_places_listings_in_sanpete_county,_utah	city#4	timezonedst
what is the predecessor of NER's election winner?	united_states_senate_election_in_north_carolina,_1990	afterelection
what is the zoning of the location in the southern part of the international football match NER?	2015_international_champions_cup	stadium#2	southeast
NER, an organization from fricktal, to which dynasty the legislature of its country belongs	research_institute_of_organic_agriculture	country#1	legislature	house#0
what is the religion of NER's clients?	egelund_house	client	house	country#1
NER, a municipality in the city of Osona Comaca, Catalonia, Spain, where is its northwest area	gurb	timezone1dst
what is the common language of people, things and things that have the same name as NER?	french_destroyer_tonkinois	shipnamesake
who is the leader of NER's successor?	colony_of_greenland_(1950–53)	leader
what is the zoning of the location in the southeast of NER, a town in Washington County, Utah, United States?	new_harmony,_utah	subdivisiontype#2
who are the generals of the people in NER?	germanic_wars	name
who is the father of NER's name	uss_john_rodgers_(dd-574)	shipnamesake
town in Box Elder County, Utah, United States, what is the area of NER, the location in the east, and the location in the south?	howell,_utah	subdivisionname#0
what time zone does the administrative center of the birthplace of the Malaysian hockey player NER belong to?	kuhan_shanmuganathan	birthplace#1	legislature
which division does the location in the east of NER's city belong to?	national_register_of_historic_places_listings_in_box_elder_county,_utah	city#2	east
which state is the NER election winner in?	united_states_senate_election_in_vermont,_1980	afterelection	state
where is the location in the west of the city where NER is located?	canyon_mountains	city#0	west
who is the predecessor of NER's election winner?	romanian_general_election,_1922	afterelection	predecessor#1
who is the father of NER's client	egelund_house	client
who is the successor of the descendants of NER?	leopold_iv,_duke_of_anhalt	issue#2
The field the person whose name is used to name the NER belongs to	boltzmann_(crater)	eponym	field
what common language is used for flag events established by the location of NER?	colombia_national_football_team_results_(1980–99)	location#4
NER's location what area is the east location in?	south_carolina_highway_151	location#0	east
what instrument did the creator of NER use	etta_james_(1973_album)	writer
The royal family of the person, thing, and thing with the same name as NER	ss_prinses_astrid	shiproute
what is the famous work of the person named NER?	harden_(crater)	eponym
where did NER's election winner's voters come from?	election_committee_(legislative_council_constituency)_by-election,_2001	afterelection
which dynasty does the legislature where the NER take place belong to?	2007_davis_cup_world_group	venue#0	legislature	house#0
A city in Cage County, Utah, United States, where is the location north of NER, which time zone is the location west of?	logan,_utah	north#2	southwest
what war did the person or thing with the same name as NER participate in?	hms_bramham_(l51)	shipnamesake
what is the common language spoken in the administrative region to which NER belongs?	governor_of_genoa	body	governmenttype
NER, the US college basketball season, which time zone is its home eastern location in	2015–16_idaho_vandals_men's_basketball_team	home#0	northwest	timezonedst
what is the industry of NER's sponsor?	summerslam_(1994)	sponsor	industry
what is the previous generation of the election winner of the convention NER that elects the U.S. senator?	united_states_senate_election_in_ohio,_1898	afterelection	before#1
NER's election winner whose last term was	thai_general_election,_1996	afterelection
what is the name of the alma mater of NER's election winner	labour_party_(uk)_deputy_leadership_election,_2015	afterelection	honorificsuffix
in which city is NER's alma mater?	albert_camus	almamater
which district does the mayor of NER belong to?	canton_of_remiremont	chieftown
what titles do people, things and things with the same name as NER have?	french_ship_charlemagne_(1852)	shipnamesake	title#2
A city in Garfield County, Utah, United States, where is the location in the north of NER, in which area is the location in the east?	escalante,_utah	namedfor
NER, Earl of Limburg and Morse (1545-1589), to which division the birthplace of the previous generation belonged	adolf_van_nieuwenaar	before#1
NER, a football championship season, what is the constituency of the location in the east of its venue	2013–14_isthmian_league	stadium#1	east
what is the constituency for the location west of a sports cricket match NER?	1993_women's_cricket_world_cup	venue#0	west
which division does the southern part of the NER site belong to?	2012_toulon_tournament	stadium#0	northwest
who is the successor of NER's election winner?	israeli_legislative_election,_1992	afterelection	predecessor	successor
town in Uinta County, Utah, USA, what is the area of NER, the location east of the location, and the location in the northwest?	ballard,_utah	west	west	west
what dynasty belongs to a person or thing with the same name as NER?	rms_queen_mary_2	shipnamesake	issue#0
who is the leader of the legislature for the position of NER	bhutan_national_football_team_results	stadium#0
what is the zoning of the location in the southwest of NER's place of residence?	pim_fortuyn	title#0
in which area is the same name of NER?	hmcs_amherst	shipnamesake
who is the emperor of the person or thing related to the result of NER	kalmar_war	result
what team is the head coach of NER on?	2014–15_sc_freiburg_season	s
A town in Wayne County, Utah, U.S.A. what is the area of NER?	loa,_utah	southeast
what is the predecessor of the previous generation of the descendants of NER	adad-nirari_iii	issue#0	before
Wikimedia lists the location of the article NER what region does the location in the east belong to?	list_of_sigma_pi_chapters	location#2	east	subdivisionname#2
The 38th season in franchise history; what zone does the location in the northeast of the first Super Bowl winner NER belong to	2013_seattle_seahawks_season	stadium#0	southwest
what is the party affiliation of the legislature for the position of the football team for a season NER?	1980–81_eintracht_frankfurt_season	location#4
Whose predecessor was the place where the NER label was held?	atp_world_tour_masters_1000	label#0	venue	after#3
what is the tenant of the NER's venue named?	2001_kyoto_purple_sanga_season	stadium#0	tenants
which dynasty does the spouse of a descendant of NER belong to?	sigebert_iii	after
which president does the NER's election winner serve?	israeli_legislative_election,_1992	afterelection
where is the location in the southeast of NER's venue?	1968–69_inter-cities_fairs_cup	stadium#0	southeast
where is the district where the election winner of the Wall NER is located?	united_states_senate_election_in_wyoming,_2000	afterelection	branch
what area is the southern city of NER in?	massalcoreig	s	w
who is the predecessor of NER's election winner?	french_legislative_election,_1914	afterelection	predecessor
what is the region of the NER location in the west and the location in the northeast?	pé_de_plátano	southeast
what is the zip code of the location in the northeast of NER?	list_of_former_maryland_state_highways_(200–399)	location#1	blankname
what is the rank of Wallner's election winner?	united_states_senate_election_in_wyoming,_2000	afterelection	rank
what is the zoning of the location in the northwest where NER died?	willis_h._downs	deathplace#1
what awards have people or things with the same name as NER won?	usns_lewis_b._puller_(t-esb-3)	shipnamesake	awards#3
what time zone is used in the city where the NER is held?	1996–97_uefa_cup	stadium#3
what is the religion of NER's election winner?	labour_party_(uk)_deputy_leadership_election,_2015	afterelection	honorificsuffix
who is the successor of NER's election winner?	nigerien_general_election,_2016	afterelection	title#1	incumbent
what area does the location in the north of NER belong to?	hurricane,_utah	north#1	subdivisionname#1
which empire does NER's father belong to?	elihia	father	dynasty
what is NER's famous work of the same name?	spanish_cruiser_don_antonio_de_ulloa	shipnamesake
NER's election winner whose last term was	united_states_senate_election_in_ohio,_1898	afterelection	state
who is the king of NER's father (mother)	francis_russell,_marquess_of_tavistock	parents	monarch#0
who is the successor of the successor of the descendants of NER?	élisabeth_charlotte_d'orléans	after
what is the country of NER's election winner?	manila_local_elections,_2016	afterelection	country
what is the location of NER? what is the location in the north?	2012–13_leicester_city_f.c._season	location#2
what is the time zone of the location in the NER Northwest and the location in the Southwest	scofield,_utah	timezonedst
where is NER located in the North West	2012_jiangsu_sainty_f.c._season	location#2
what is the zip code of the person, thing, thing with the same name as NER	hmcs_levis_(k400)	shipnamesake	east	subdivisiontype
what is the time zone of the location in the south of the NER and the location in the southwest	provo,_utah	south#0	timezonedst
in which area is the location south of NER, a municipality in Comaca, Anoia, Catalonia, Spain	carme,_barcelona	w
who is NER's predecessor of the same name	fortitude_(1780_eic_ship)	shipnamesake	predecessor
where do voters with the same name as NER come from?	usns_harvey_milk_(t-ao-206)	shipnamesake	constituency#1
NER, submachine gun, which national system is used to mark events established where it is used	mp_34	usedby#1
what is the state of the election winner of NER, the convention that elects the U.S. senator?	united_states_senate_election_in_ohio,_1898	afterelection	state
Express trains between Brussels, Belgium and Switzerland (formerly Italy). what is the dynasty to which the legislature of NER's place belongs?	vauban_(train)	locale#1	legislature
who is the leader of the flag event established by the location of NER	2008_in_american_soccer	location#0	south
who is the general of the person or thing with the same name as NER?	chilean_corvette_chacabuco_(1815)	shipnamesake	commander#1
NER, Wikimedia listing article, what time zone is used for its location south of the city	national_register_of_historic_places_listings_in_larimer_county,_colorado	city#0
what is the title of the location leader in the eastern part of the football game NER?	2015_afc_champions_league_final	title	name
which party does Wallner's election winner belong to?	united_states_senate_election_in_south_dakota,_2014	afterelection
who is the successor of the descendants of Queen NER of Sweden?	josephine_of_leuchtenberg	issue#2
what is the flag event established by the location of the National Team of the Football Players Association NER?	lin_xiaocheng	countryofbirth	southeast
which event determines the establishment of the area to which NER's nationality belongs	luo_ji	nationality	region#6
NER's position is named after whose predecessor	state_highways_serving_virginia_state_institutions	location#2	southeast	east
what are the titles of the location leaders in the northwest of the NER's location?	2012_chinese_fa_cup	team#1
NER, a municipality in la selva comarca, Catalonia, Spain, to which division its northwest location belongs	osor,_girona	nw	subdivisiontype
NER, diplomat and statesman of Imperial Japan (1887-1957), who was the predecessor of his successor's previous generation	mamoru_shigemitsu	after#1	party
awhere is the location of Guangzhou Evergrande Taobao 2015NER in the northeast?	2015_guangzhou_evergrande_taobao_f.c._season	location#2
what is the title of the successor of NER's venue?	uzbekistan_national_under-23_football_team_results	stadium#0	caption
what is the zoning of the location in the southeast of NER's home field?	2014–15_byu_cougars_women's_basketball_team	champion	coach
what is the name of NER, the leader of the location of the Northeast location of the football team for a season	2012_shanghai_shenxin_f.c._season	location#0	northwest
who is the successor of the successor of the descendants of NER?	louis_the_german	successor#0
what is the previous generation of the founding emperor of NER's dynasty	norodom_kanviman_norleak_tevi	house#0
NER, a coal mine in Russia, where is it located in the western part of the province	sakhalin_coal_mine	country	legislature
who is NER's successor's predecessor's next	louis_the_younger	spouse
what is the religion of the country (city) affected by NER	1857_basilicata_earthquake	countriesaffected	religion
who is the successor of NER's election winner?	tunisian_constituent_assembly_election,_2011	leader
NER, 1880, who was the electoral winner of the New Zealand by-election	rangitikei_by-election,_1880	afterelection	honorificsuffix
who are the producers of NER-related products	nokia_lumia_625	manufacturer
who is NER's candidate for the previous generation of kings?	eden_(new_zealand_electorate)	candidate#1
who is NER's namesake loyal to?	russian_destroyer_marshal_shaposhnikov	shipnamesake	allegiance	legislature
where does the current incumbent of the title of NER take office?	ho_chi_minh	before
which party does the person, thing, or thing with the same name as NER belong to?	uscgc_duane	shipnamesake	title	seat
NER, a song sung by skrillex, what is the occupation of its creator	ragga_bomb	chronology
what time zone is used for the location in the southern part of the NER	2012_afc_challenge_cup_qualification	stadium#3
what is the previous generation of NER's generals?	battle_of_legnano	commander	predecessor#0	predecessor
NER, American college basketball season, what is the zoning of the location north of its home	2014–15_utah_utes_men's_basketball_team	home#0	south
NER, where did the election winner of the New Zealand by-election in 1880 die	rangitikei_by-election,_1880	afterelection	honorificsuffix
NER's election winner who's successor	persian_legislative_election,_1906	afterelection
who is the spouse of the previous generation of the title of NER?	list_of_wtf_with_marc_maron_episodes	title#1	spouse	spouse
The location of the Wikimedia roster NER The name of the location leader in the east is	macedonia_national_football_team_results	location#2	legislature
NER, a season of a football team, which league does the tenant of its host play in	2012_f.c._tokyo_season	stadium#0	tenants	name#0
what is the division of the southern city of NER?	tortellà	s
who is the successor of the place where NER is held?	2011–12_lekhwiya_sc_season	stadium#1	after	after#2
what is the form of the title of the venue of NER?	football_at_the_1990_asian_games_–_men	stadium#0	title	format
who is the successor of the person, thing, thing with the same name as NER?	uss_hancock_(1776)	shipnamesake	successor#0
what is the predecessor of the person or thing concerned with the consequences of a battle in China in 617 AD?	battle_of_huoyi	result
NER, the US college basketball season, what is the time zone of the location north of its home field	2014–15_utah_state_aggies_men's_basketball_team	home#2	southwest
who is the successor of the descendants of NER's spouse	ptolemy_x_alexander_i	successor
what is the title of NER's election winner	cape_verdean_parliamentary_election,_2016	beforeelection	title
what is the title of the previous generation of the descendants of the Austrian Duchess NER	viridis_visconti	issue#0	before#0	title#2
which region type does the location in the northwest of the region to which the NER belongs	phu_phan_mountains	region#1	southwest
what are the titles of NER's generals?	battle_of_durbey	combatant
who is the predecessor of the previous generation where NER was held?	2016_chinese_fa_cup	stadium#5	tenants
what is the predecessor of the successor of NER's venue	2014_fifa_world_cup_qualification_–_afc_third_round	stadium#0
which president does the NER's election winner serve?	bosnian_general_election,_2014	afterelection
who is the predecessor of NER's election winner?	wisconsin_gubernatorial_election,_1986	afterelection	predecessor#1
where the person or thing with the same name as NER happened	french_fluyt_égyptienne_(1812)	shipnamesake	place#0
who is NER's predecessor of the same name	russian_cruiser_gerzog_edinburgski	shipnamesake	after
what is the type of product or work related to NER	sony_xperia_z2a	related	type#0
NER's location what area does the location in the northwest belong to?	list_of_lambda_chi_alpha_chapters	location#0
who was the president of NER's previous generation	pierre_pflimlin	before#1
where does the source of the NER name belong?	cézanne_(crater)	eponym
A battle during the Mongol invasion of Hungary in the 13th century which religion did the participating nations of NER believe in?	battle_of_the_tisza	combatant	religion#3
NER, a village, what is the division of its southern area	sant_esteve_de_la_sarga	s	subdivisiontype
where are the leaders of NER installed?	london_local_elections,_2018	leader
which religion does NER's election winner belong to?	united_states_senate_election_in_north_carolina,_1998	afterelection	religion
who is the name used to name the person influenced by the NER?	donne_(crater)	eponym	influenced#4
what was the previous generation of the leaders of the NER, a monarchy in northern Portugal (January-February 1919)	monarchy_of_the_north	leader	before
which party does the legislature where the NER is held belong to?	1974_davis_cup_europe_zone	venue#2	commonlanguages#0
who is the leader of the administrative area to which NER belongs?	governor_of_genoa	body	leader#1
what is the zoning of a city in Cage County, Utah, United States, NER, location, northeast, location, northeast, location?	mendon,_utah	postalcodetype
what is the title of the location leader in the east of where the NER is held?	2012_afc_champions_league_knockout_stage	stadium#0
who is the predecessor of the current incumbent of the title of former general secretary of the Lao People's Revolutionary Party NER?	choummaly_sayasone	party
NER, a television series whose title is the leader of the legislature	drugs,_inc.	title#2	northwest
NER, New Zealand Rugby League football player (1995-), where is his birthplace?	taane_milne	birthplace#1
who is the predecessor of NER's election winner?	election_committee_(legislative_council_constituency)_by-election,_2001	afterelection	district
what is the dynasty to which a football team's season NER's position is established?	2010–11_c.d._motagua_season	location#2	seat
who is the leader of the parliament in which NER holds a seat	indonesian_militant_democratic_party	chairman
which religion is the NER event?	upper_germania	nation	capital
who is NER's father's successor?	princess_of_qingdu	father
what is the rank of NER's election winner?	guatemalan_general_election,_2011	afterelection	title
where was the person named NER born	haldane_(lunar_crater)	eponym	education
who is the mother of the leader of NER	albanian_kingdom_(1928–39)	religion#0
what is the previous generation of NER's election winner?	italian_general_election,_1874	afterelection
NER, in 1869, what titles were the leaders elected by the Spanish generals	spanish_general_election,_1869	leader	before
who is the architect of the same name of NER	osterley_(1780_eic_ship)	shipnamesake	architect	placeofbirth#0
who leads the administrative area to which NER belongs	governor_of_genoa	body	leader#1
A country dominated by Durbar Khant, located in the region of Hatumo, where the leader against the imperialist NER that existed from 1896 to 1921 was born	dervish_state	commonlanguages
what is the parent class of NER's related products	axe_(brand)	currentowner
what is the offshoot of the person or thing with the same name as Francia's House Hotel NER?	french_cruiser_foch	shipnamesake	branch
who is the general who is the actual controller of NER?	ins_trata	controlledby	commander#1
what wars happened in the era of named characters named as NER	empedocles_(volcano)	type
who are the children of Wallner's election winner?	south_korean_presidential_election,_1978	afterelection
where is the birthplace of the person whose name is in NER	list_of_awards_and_nominations_received_by_bunga_citra_lestari	name
who is the president of NER's team?	red_bull_rb12	team	owner
which sea area does NER's name belong to?	uss_tutuila_(arg-4)	shipnamesake
which dynasty the person or thing related to the consequences of NER belongs to	battle_of_tanshebrai	partof
what is the honorific prefix for NER generals?	battle_of_varese	partof	partof
where are the people, things and things with the same name as NER	uss_tutuila_(arg-4)	shipnamesake	location
what party does the leader of NER belong to?	provisional_people's_committee_for_north_korea	legislature
who is the king of NER's election winner	romanian_general_election,_1922	afterelection
what is the title of the leader of the administrative area for which NER is responsible?	governor_of_genoa	body	titleleader
who is the sponsor of NER starring	night_of_champions_(2012)	sponsor
who is the publisher of NER's sponsor?	armageddon_(2008)	stip
what time zone is the location south of NER in?	poboleda	subdivisiontype
which NER's client belongs to?	ira_goldstein	client
where does NER's famous work belong to?	meyer_amschel_rothschild	religion
who is the creator of NER?	it's_a_spongebob_christmas!_album	chronology
what type of archipelago does NER belong to?	milos	archipelago	type
who is the successor of NER's general	battle_of_long_point	commander
what war did the man in charge of NER fight in?	ins_trata	controlledby	battles
what race is the person, thing, thing with the same name as NER?	mv_yulius_fuchik	shipnamesake
And NER, an Arleigh Burke class destroyer, where does the person, thing, thing with the same name belong	uss_carl_m._levin	shipnamesake	order#0
where was the creator of NER born	can_i_borrow_a_dollar%3f	chronology	format	owner
which event determined the birth country of the Croatian footballer NER?	igor_cvitanovic	countryofbirth	label#2
what type of NER's famous works belong to?	john_pemberton	knownfor	type
who is the client of the NER, a historic building in Corleone, Italy?	royal_palace_of_ficuzza	client
what is the name of the place east of the largest city in NER, a federal state in Brazil	mato_grosso	seat
which country is NER's customer from?	warner_elevator_row	client
who is the coach of NER's team?	2006–07_orlando_magic_season	team	manager
what labels are there for countries that use NER	ongota	states	label#2
what is the fame of the person whose name was used to name NER?	boltzmann_(crater)	eponym	workinstitution#2
where did the name NER come from?	eijkman_(crater)	eponym
what school did the singer of the NER song graduate from?	tokyo_juliet_(tv_series)	extra#0
what is the common language used in the relevant area of NER related events?	kingdom_of_galicia_and_lodomeria	event#0	commonlanguages
where did the voters played by NER come from?	felix_chung	constituency
what are the descendants of the person or thing with the same name as NER?	rms_queen_mary_2	shipnamesake	issue#0
what is the religion of the same name of NER?	usrc_james_madison_(1807)	shipnamesake	religion
what is the name of the place in the southwest of the country where NER is located?	bled_castle	locationcountry	southwest
which national team is the person in the national football team NER?	brunei_national_under-21_football_team	name	nationalteam#2	location#2
where does the leader of NER belong?	united_kingdom_general_election,_1886_(ireland)	leader	honorificprefix
what is the award of the same name of NER?	german_cruiser_blücher	shipnamesake	birthplace
what is the headquarters address of the participating countries of the Civil War NER?	civil_war_in_the_republic_of_congo	combatant
who is the successor of the person or thing concerned with the consequences of the Battle of NER in 1106 during the invasion of Normandy by Henry I	battle_of_tanshebrai	commander#1
who is the successor of NER's client?	royal_spring,_warsaw	client
where did NER's namesake graduate from?	french_aircraft_carrier_joffre	shipnamesake	education
which is the branch of the election winner of the Wall NER?	thai_general_election,_1996	afterelection
what area does the mayor of NER belong to?	canton_of_nemours	chieftown	subdivisionname#0
what are the affiliations of NER's alma mater	ed_jackson_(tennessee_politician)	almamater
what are the descendants of NER's descendants?	leopold_iv,_duke_of_anhalt	issue#0
what type of creators are NER	they_all_went_to_mexico	chronology	genre#1
what type of country is NER's participating country?	battle_of_chiayi	combatant	commonlanguages
where did NER's namesake die?	sas_president_kruger_(f150)	shipnamesake	placeofdeath#2
what is the common language spoken in the country of birth of the Congolese footballer NER?	gabriel_sacuiani	countryofbirth	commonlanguages#0
what is the origin of the person whose name is used to name NER?	penticton_(crater)	eponym	south
who is the director of the same name of NER?	wet_nellie	shipnamesake	studio
who is the leader of NER's successor?	united_kingdom_general_election,_1886_(ireland)	leader
1998 single, what is the ex-creator of NER by Shaquille O'Neal, dj Quick, Lord Tariq and Peter Gunz	the_way_it's_goin'_down	chronology
what type of school is NER's alma mater?	greg_gard	sport
what are the countries with the same name participating in NER	sas_isandlwana_(f146)	shipnamesake
who is the ruler of the children of the British statesman (1836-1914) NER	joseph_chamberlain	children	primeminister	monarch
which province is the client of NER in?	ludvika_town_hall	client
who is the successor of NER's related products?	sony_xperia_z3+	after
what type of people are in NER	list_of_awards_and_nominations_received_by_billy_ray_cyrus	name	genre#1
who founded the record company NER belongs to?	destiny_(game)	label
what is the predecessor of the leader of NER	spanish_general_election,_1869	leader	before
who does the information about the participating countries of Middle-earth NER come from?	battle_of_bangorach	combatant
who is the next general of NER?	battle_of_legnano	commander	successor
which dynasty did the descendants of NER belong to?	belengalia_(castile)	predecessor	house
who is the current incumbent of the leader of NER?	community_of_saint_anselm	leader	incumbent
who is the author of the singer who participated in NER	3/8_(album)	extra
who is the Prime Minister of Irish politician NER's father and mother	francis_russell,_marquess_of_tavistock	parents	monarch#0
who is the successor of the general of the medieval war NER?	battle_of_legnano	commander	successor
who is the predecessor of NER's parents?	francis_russell,_marquess_of_tavistock	parents	predecessor#1
who is the president of NER's sponsor	old_newton_cup	sponsor	locationcity
NER, a fief of the Holy Roman Empire, what caused the events associated with it	archduchy_of_austria	event	result
2013 UEFA Women's Euro 2013 Final Match NER Related Events Tag What	uefa_women's_euro_2013_final	event	stadium#0
what time zone does the volleyball player NER's team use?	liset_herrera	team	timezone
where NER's election winner takes office	northern_cyprus_presidential_election,_2015	afterelection
who created the work that made American voice actor NER known?	sarah_natochenny	notableworks	creator
who is the founder of the actual controller of NER?	brownsea_castle	controlledby	founder
what is the language of the people in NER	list_of_awards_and_nominations_received_by_craig_david	name	language
what is the profession of the singer who performed for omarion's album NER	ollusion	extra	occupation#2
who legislates in the country where NER is located?	bled_castle	locationcountry	legislature
what is the religion of Wallner's election winner?	united_states_senate_election_in_nebraska,_2002	afterelection	religion
where was the creator of NER born	the_milt_jackson_big_4	chronology
where are the descendants of NER buried	ramiro_i_of_asturias	placeofbirth
which institution does NER's alma mater belong to?	frank_darling_(architect)	almamater
what is the legislature of NER's country of birth	igor_cvitanovic	countryofbirth	legislature
what is the identity of NER's namesake	hms_montserrat_(k586)	shipnamesake	currency
In a French state (as of March 2015) which district is the main town of NER	canton_of_montreuil	chieftown
where are NER's customers located?	ira_goldstein	client
what is the name of the election winner for NER	united_malays_national_organisation_leadership_election,_2009	afterelection
what war happened in the era of NER's events	kingdom_of_galicia_and_lodomeria	event#0	event
who is NER's father next?	heshuo_hehui_princess	father
who are the participating teams of the creators of NER?	the_way_it's_goin'_down	chronology
where is the address of NER's namesake	french_ship_rivoli_(1810)	shipnamesake	place#0
NER, the first prime minister of India (1889-1964), whose parents were his successors	jawaharlal_nehru	children
what is the title of the NER, a former national, and its relevant event leader	kingdom_of_galicia_and_lodomeria	event#0	titleleader	appointer
what is the alma mater of someone affected by NER	alain_badiou	maininterests
NER, a mine in Russia, what is the legislature of its province	pyrkakay_mine	country	legislature
who did NER's clients influence	ramsay_garden	client
which sponsor of NER belongs to?	2011_penrith_panthers_season	name	birthplace#1
where is the birthplace of the coach of the Malaysian badminton player NER	hafez_hashim	coach
who was influenced by the person whose name was used to name NER?	aryabhata_(crater)	eponym	region	establishedevent
who leads the countries and regions affected by NER	1857_basilicata_earthquake	countriesaffected	leader#0	issue#4
what type of country is the country using NER	tokelauan	nation
what is the name of the alma mater of the person named NER?	nagaoka_(crater)	eponym
what is the ex of the client of NER, a historic building in Corleone, Italy	royal_palace_of_ficuzza	client
who has appeared on NER's related products (works)	happy_family	related
To whom do NER's sponsors pledge their allegiance	palm_of_jerusalem	sponsor	author
what is the honorific suffix of NER's generals?	battle_of_long_point	commander	awards
what is the industry of NER's sponsor?	telstra_phonewords_stakes	sponsor	industry
what religion is the country of birth of the Algerian footballer NER?	rhones_garvay	cityofbirth	timezone
To whom did the leader of an ancient Greek city-state NER owe allegiance	classical_athens	legislature
who led the participating countries of the NER	grief_night	combatant	leader#2
which is the branch of NER's parent (mother)	didit_hediprasetyo	education	southwest
who are the parents of the American economist NER's parents?	franklin_delano_roosevelt_iii	parents	parents#1
what region does NER's province belong to in the country?	alderley_edge_mines	state/province	region
what religion does NER's father belong to?	elihia	father	religion
who is NER's father and mother's spouse	buhe_(politician)	parents	predecessor	premier
what country does NER's name belong to?	french_battleship_carnot	shipnamesake
what is NER's eponymous legislature	leopoldus_primus	shipnamesake	spouse
what is the part of the archipelago that NER belongs to?	milos	archipelago
which event determines the formation of a country using NER?	ongota	states	label#11
where is the birthplace of NER's election winner	belizean_general_election,_1984	afterelection	placeofbirth#0
where is the person or thing with the same name as NER?	hms_bligh_(k467)	shipnamesake
what time zone is used in the province where NER is located?	selkirk_mine	state/province	seat
who is the spouse of the election winner who elected NER?	german_presidential_election,_1994	afterelection	spouse#1
what is the company type of NER's sponsor?	vodacom_cup	sponsor	companytype
what is the next generation of NER's parents	neleus	parents	children#2
what wars were there in the era of people who were named NER	philolaus_(crater)	eponym	era
where did the person named NER die	lippershey_(crater)	eponym
what language is used by people, things and things with the same name as NER	mohawk_(1781_ship)	shipnamesake	languages#0	fam#1
what type of products are related to NER?	kinder_joy	related	type
The fuse created by people, things, and things with the same name as NER	hnoms_otra_(1939)	shipnamesake	commonlanguages
who are the descendants of NER's generals?	the_battle_of_dingtao_(eastern_han_dynasty)	commander
who are NER's parents before?	franklin_delano_roosevelt_iii	parents	state#0
what is the last work of a person or thing with the same name as NER?	wet_nellie	shipnamesake
what is the country of the subject of NER?	the_wizarding_world_of_harry_potter_(universal_studios_japan)	theme	country
what is the name of the country's prime minister of walner's election winner	peruvian_general_election,_1985	afterelection
who is the ruler of the generals of the medieval war NER	battle_of_legnano	commander	issue
what is the religion of the person whose name was used to name the lunar crater NER?	born_(crater)	eponym	religion
what is the political type of person or thing about the outcome of a battle NER in the American Civil War?	first_battle_of_newtonia	result	status
who are the successors of NER's parents?	franklin_delano_roosevelt_iii	parents	after#1
who did NER's namesake influence?	french_frigate_descartes	shipnamesake	almamater
which president does Wallner's election winner serve?	united_states_senate_election_in_north_carolina,_1990	afterelection
who is the leader of the person or thing with the same name as the 1915 Royal Navy Queen Elizabeth class warship NER	hms_malaya	shipnamesake	titleleader
NER's election winner whose last term was	brazilian_presidential_election,_1960	afterelection
what is the country of the country (city) affected by NER?	1857_basilicata_earthquake	countriesaffected	country	currencyunit
who is the leader of NER's event	upper_germania	nation	leader#1
where is the southern part of the person or thing with the same name as NER	yongfeng-class_coastal_defense_ship	shipnamesake
where was NER's father's birthplace	dongfu_see_ciqia	father	fatherofwife
where did NER play die	gordian_i	deathplace
what is the country area to which the person, thing, and thing with the same name as NER belong?	uss_platte_(ao-186)	shipnamesake
what are the labels of singers who participated in NER?	ollusion	extra	label#0
who did the origin of the NER name affect?	sherrington_(crater)	eponym	almamater#0
Who's next show for NER's writing	hiro_fujiwara	notableworks	studio
what is the name of the prime minister of the country of the leader of NER?	house_of_assembly_of_saint_vincent_and_the_grenadines	leader	primeminister
what type of company is NER related to	wingnut_films	related	companytype
which empire does NER's father belong to?	princess_of_zhongshan_(northern_qi)	father
who starred in the theme of the 2016 Universal's Islands of Adventure NER	skull_island:_reign_of_kong	designer
NER, a warship, which country is it named after	french_battleship_danton	shipnamesake
in which area is the election winner of the NER election in Minnesota?	united_states_presidential_election_in_minnesota,_1968	afterelection
which dynasty does NER-related events belong to?	gurjara-pratihara	commonlanguages
what is the previous generation of the children of the British statesman (1836-1914) NER	joseph_chamberlain	children	order	appointer
what does the creator of NER do?	lovers_(cannonball_adderley_album)	chronology
where is the capital (or provincial capital) of the location involved in the NER-related incident	first_hungarian_republic	event	capital
what era is the person or thing related to the consequences of NER?	first_battle_of_newtonia	result	era#0
who are the descendants of NER's clients?	royal_palace_of_ficuzza	client
where is NER's namesake buried	uss_troup_(1812)	shipnamesake	house	ethnicity
And NER, a car-shaped submarine from the 1976 James Bond film The Spy who Loved Me, it was made by the person or thing with the same name	wet_nellie	shipnamesake
who are the descendants of NER's father	gyeongjong_goryeo	father
what region does the mayor of NER belong to in the country?	canton_of_liévin-sud	chieftown
what titles do the related products (works) of the TV series NER have	invincible_intelligence_agent	related
what is the administrative region of the archipelago where NER is located?	new_britain_island	location
what is the name of the leader of a person, thing, or thing with the same name as NER?	hms_montserrat_(k586)	shipnamesake
which country is the leader of NER from?	french_national_convention_election,_1792	afterelection
where did the creators of NER originate from?	parachilna_(album)	chronology
NER, the fief of the Holy Roman Empire, which region is the event involved in	archduchy_of_austria	event	result
what is the name of the place in the southwest of the country where the Croatian footballer NER was born?	igor_cvitanovic	countryofbirth	southwest
NER, a female adopted child, who founded its sponsor	adopted_daughter	sponsor
who is the successor of the leader of NER?	michael_ellis_(british_politician)	leader	successor
The consequences of a battle in the American Civil War NER related to whom or who legislated	first_battle_of_newtonia	result	era#0
where did Wallner's election winners live?	peruvian_general_election,_1985	afterelection
what is the nationality of the person whose name is used to name the NER?	mendes_pinto_(crater)	eponym
what is the title of the person, thing, thing with the same name as NER?	greek_ironclad_vasilefs_georgios	shipnamesake	issue
who is the successor of Irish politician NER's father (mother)	francis_russell,_marquess_of_tavistock	parents	successor#4
what is the area to which the site belongs to the south of NER, a village in the province of Girona, Catalonia, Spain	vall-llobrega	s
what is the title of the person or thing related to the consequences of fighting NER?	battle_of_bedriacum	result
where is NER's team	1955–56_hapoel_haifa_f.c._season	stadium#0	tenants	ground
Whose name is NER's predecessor?	warren_hastings_(1802_eic_ship)	shipnamesake	monarch
who is the father of NER's client	royal_spring,_warsaw	client
who is the spouse of the person named NER?	cori_(lunar_crater)	eponym
who is the singer who participated in NER's work?	3/8_(album)	extra	studio
where do the leaders of NER work?	london_local_elections,_2018	leader
what titles are people whose names are used to name NERs	haldane_(lunar_crater)	eponym	title
where is the archipelago of NER?	fairy_shoal	archipelago	location
which teams are NER's coaches participating in?	brooklyn_nets	affiliation
what is the previous generation of the coach of the men's National Football Association football team NER representing India?	indian_national_football_team	coach
what is the rank of the person or thing with the same name as NER?	german_destroyer_mölders	shipnamesake	rank
who is NER's team that directed the work?	red_bull_rb12	team	owner
who is the leader of the NER to legislate?	albanian_kingdom_(1928–39)	legislature
WHAT PRODUCTS FROM THE TEAM OF FRENCH MOTOCROSS NER NER	thomas_pagès	otherinterests
which event determines the establishment of the country in which NER is located?	bled_castle	locationcountry	establishedevent#2
what is the nationality of the person whose name is in NER?	list_of_awards_and_nominations_received_by_craig_david	name	nationality
where is the address of the event involved in NER	empire_of_china_(1915–16)	event
where is the capital (or provincial capital) of the person, thing, and thing with the same name as the Colony-class frigate NER	hms_st._helena_(k590)	shipnamesake	establishedevent#2
what is the common language of the 1915 Royal Navy Queen Elizabeth class battleship NER of the same name	hms_malaya	shipnamesake	commonlanguages
who has the name in NER influenced by?	empedocles_(volcano)	type
where are the major events of the NER held?	2010–11_queens_park_rangers_f.c._season	stadium
what is the representative of the country that uses NER, a language of the ancient Korean Baekje Kingdom	baekje	commonlanguages
what is the occupation of the same name of NER?	type_0891a_training_ship	shipnamesake
what is the religion of the leaders of NER?	united_states_of_indonesia	leader	religion
what is the type of the same name of NER	uss_mauna_kea_(ae-22)	title
where are people, things and things with the same name as NER buried?	french_ship_charlemagne_(1852)	shipnamesake	succession#2
Whose predecessor did NER play	decius	successor
who is the star of NER's famous work?	khalid_siddiqui	notableworks
where are the birthplaces of those affected by NER	bernard_lewis	maininterests
what city is in the southwest of NER's province	sakhalin_coal_mine	country	capital
who is the artist who posted the theme of NER	skull_island:_reign_of_kong	designer
who created the products or works related to NER	supergirl_(tv)	company	owner
what do the creators of NER do?	unbreakable_(janet_jackson_album)	chronology	profession#2
what are the types of sponsors for NER	wwe_breaking_point	sponsor	genre
with a floating nuclear power plant in Russia. NER what field does the person, thing, and thing with the same name belong to?	akademik_lomonosov	shipnamesake	workplaces
where is the southern part of the province where NER is located?	sakhalin_coal_mine	country	legislature	house#0
what religion do the descendants of NER believe in?	jizen_pema	religion
what dynasty does NER's client belong to?	royal_spring,_warsaw	client	title	incumbent
what caused the name of the warship NER during World War II	greek_destroyer_pindos	shipnamesake
in which province is NER's alma mater?	amy_jephta	almamater	provinceprovince
in which state is NER's alma mater?	mark_van_ameyde	almamater
what dynasty did NER's father belong to?	princess_huaining	father	succession	incumbent
what is the type of person whose name is used to name the NER	bolsena_lacus	eponym	type
what tag does Brunei football player NER's national team place on	charanchan_said	nationalteam	location#2
what area does the location in the southeast of NER's home ground belong to?	2015–16_kentucky_wildcats_men's_basketball_team	home#2	legislature
Taiwanese politician, for which president did the predecessor of the former president of the Republic of China NER's provincial premier serve	ma_ying-jeou	president	before
which dynasty belongs to the legislature of the NER's home during the college basketball season?	2015–16_iona_gaels_men's_basketball_team	home#2
where is the place of death of the successor of the descendants of NER?	mary_of_hungary,_queen_of_naples	succession
what area does the location in the southeast of NER's venue belong to?	2013_rugby_league_world_cup	stadium#0	subdivisionname#0	governmenttype
NER, a football championship season, which time zone the location northeast of its location belongs to	2015_ncaa_division_i_men's_soccer_championship	location#1	southwest
what is the previous generation of the previous generation represented by NER?	boston	imagecaption#2
who is the father of the ruler of the descendants of NER	albert_i_of_belgium	issue#0	father
what is the type of successor to the creator of NER	grammy_nominees	title#6
what is the area of the location in the south of NER's headquarters address?	scouting_in_colorado	headquarters#0	south
what are the titles of the previous generation leaders of the position of the NER of a football team in a season?	2015_beijing_guoan_f.c._season	location#2	southeast
what is the name of the leader of the administrative center where NER is located?	nzr_p_class_(1885)	locale#0	location
what is the time zone of the location in the south of NER, a town in Sampitt County, Utah, United States?	wales,_utah	timezonedst
what are the last descendants of the descendants of NER, the Dukes of Parma and Piacenza from 1854 to 1859	robert_i,_duke_of_parma	issue#5
what time zone does the location in the southern part of NER's venue belong to?	2003_iwcc_trophy	venue#0
A town in Millard County, Utah, United States, the location in the southeast of NER, the location in the north, and which time zone does the location belong to?	holden,_utah	timezonedst
NER, a sporting event, which district is the city in the west of the city where it is located	2001_women's_hockey_world_cup_qualifier	city#0	w
who is the first king of the title of NER?	fernándo_norzagaray_y_escudero	title#1	last
what time zone does the location in the north of NER belong to?	uintah,_utah	timezonedst
what is the provincial capital of the location in the west of the NER's venue?	lincoln_county_war	place#1	legislature
what is the previous generation of the successor of NER's venue	thailand_national_football_team_non-international_results	stadium#0
do you know who was hit by The name of the ship of NER, a historic French ship?	french_frigate_descartes	shipnamesake	almamater
who is the customer of the NER label	permanent_mission_of_the_people's_republic_of_china_to_the_united_nations	label	appointer	deputy
what is the title of The NER Related Thing	invincible_intelligence_agent	related
who was the NER leader before	spanish_general_election,_1869	leader	before
what is the dynasty of The father of NER	princess_of_zhongshan_(northern_qi)	father
do you know what the agency headed by The head of NER is	united_kingdom_general_election,_1886_(ireland)	leader	honorificprefix
what is the successor to The winner of NER, a 1106 battle during the invasion of normandy by henry i?	battle_of_tanshebrai	partof
what is the race of NER's ship name	mv_yulius_fuchik	shipnamesake
what religion does NER's descendant believe in?	jizen_pema	religion
do you know what is the agency headed by NER's ship name	uss_carl_m._levin	shipnamesake	order#1
who is the wife of NER Timeline, an album by garth brooks?	christmas_together	chronology	spouse
what dynasty belongs to Events in NER, an indian dynasty that ruled much of northern india from the mid-8th century to the 11th century?	gurjara-pratihara	commonlanguages
who is the predecessor of The Children of the NER, a British politician (1836-1914)?	joseph_chamberlain	title
do you know who is next to The winner of NER, a battle?	battle_of_bedriacum	result	placeofdeath	subdivisionname#1
do you know what is the organizational model of the municipal management of the events in NER, a geographical object, Bavarian?	karelian_autonomous_soviet_socialist_republic	commonlanguages#0
do you know what awards Next to NER has won	takashi_sakai	office
do you know what is the house of The winner of NER	battle_of_tanshebrai	partof
do you know what is the famous work of The name of the ship of NER	french_submarine_joule	shipnamesake	influences
what is the battle of Election after NER, a wahl?	south_korean_presidential_election,_1980	afterelection
do you know what was the last show of The notable works of NER, a japanese manga artist?	hiro_fujiwara	notableworks	studio
what is the education of NER's ship name?	french_aircraft_carrier_joffre	shipnamesake	education
do you know what happened in NER's ship's name, a 1915 queen elizabeth-class battleship of the royal navy?	hms_malaya	shipnamesake	commonlanguages
what is the type of manager of NER	waterstones_11	location	legislature
who are the generals participating in the NER name	germanic_wars	name
do you know what is the estate of NER's ship name	leopoldus_primus	shipnamesake	house#0
do you know who is the partner of NER's ship name	hms_ariadne_(1816)	shipnamesake
do you know where is the birthplace of The leader of NER, a city-state in ancient Greece?	classical_athens	legislature
where is the death place of NER's ship name	sas_president_kruger_(f150)	shipnamesake	placeofdeath#2
do you know what is the nationality of the head of NER	french_national_convention_election,_1792	afterelection
do you know what timezone the province where NER is located in, a bergwerk in botswana?	selkirk_mine	state/province	seat
do you know who is the leader of Election after NER	romanian_general_election,_1922	afterparty	leader1name
who are the founders of Le label de NER	destiny_(game)	label
what are the countries of people, things and things with the same name as participating NER	sas_isandlwana_(f146)	shipnamesake
To whom responsible for NER is loyal	palm_of_jerusalem	sponsor	author
do you know what is the type of The sea around the NER	milos	archipelago	type
what is the organization run by The Parents of NER	francis_russell,_marquess_of_tavistock	parents	order#0
What's before The NER Coach	indian_national_football_team	stadium#0
what eponymous domain of NER belongs to	cavendish_(crater)	eponym	field#0
do you know who is the wife of Election after NER	german_presidential_election,_1994	afterelection	spouse#1
do you know who are the descendants of Client of NER, a historic building in corleone, italy?	royal_palace_of_ficuzza	client
do you know what time zone is using NER ship name	hmcs_parry_sound	shipnamesake	timezonedst
do you know who is the founder of the The name of the ship of NER, a russian cruiser?	soviet_cruiser_komintern	shipnamesake	ideology#0
in which country is the The name of the ship of NER	french_battleship_carnot	shipnamesake
what is related to NER's ship name	uss_hopi_(at-71)	shipnamesake
do you know what kind of NER ship name	ms_henrik_ibsen	shipnamesake	genre
who is the heir of Next to NER, a Roman emperor (201-251)?	decius	successor
who is the heir to NER's parents, an Irish politician?	francis_russell,_marquess_of_tavistock	parents	successor#4
do you know where NER customer come from	ira_goldstein	client
who is the creator of NER's Notable Works	sarah_natochenny	notableworks	creator
do you know what is the specialty of Election after NER	italian_general_election,_1992	afterelection	honorificsuffix
what is the profession of The name of the vessel of NER	type_0891a_training_ship	shipnamesake
which party is the NER leader	indonesian_militant_democratic_party	seats1title
where is the Alma Mater of The Leader of NER	united_kingdom_general_election,_1886_(ireland)	leader	honorificprefix
what is the type of The name of NER	list_of_awards_and_nominations_received_by_billy_ray_cyrus	name	genre#1
do you know where the headquarters of NER Country, a civil war, participant is located?	civil_war_in_the_republic_of_congo	combatant
what was the last term of the Country of NER, a war, participant?	irish_civil_war	result	house#0
do you know what ethnicity belongs to NER's ship name?	type_0891a_training_ship	shipnamesake	nationality
what are the important positions of The name of the ship of NER	sms_hindenburg	shipnamesake	office
what state is Election after NER, a wahl?	united_states_senate_election_in_west_virginia,_2014	afterelection
who is the actor in The Name of NER's Ship	wet_nellie	shipnamesake
do you know what is the name of the administrative district of The main city of NER	canton_of_nemours	chieftown	subdivisionname#1
do you know what is the postalCodeType of the area where NER is used	jincheng_dialect	states	language
who was the last of Parents of NER, an american economist?	franklin_delano_roosevelt_iii	parents	before#1
do you know who is next to the NER coach	indian_national_football_team	coach
do You Know who Is NER's Timeline Wife	someone_put_your_hand_out_(michael_jackson_song)	chronology	spouse#1
Did you know that the common languages of NER's country of origin, a footballer, were Congolese?	gabriel_sacuiani	countryofbirth	commonlanguages#0
do you know who the parents of The Children of the NER are	anwar	almamater
what era did the eponym of NER come from	haldane_(lunar_crater)	eponym	education
do you know what the southwest of NER country is	bled_castle	locationcountry	southwest
do you know who the NER timeline was before	the_way_it's_goin'_down	chronology	before#1
who is the president of Election after NER, a wahl?	united_states_senate_election_in_north_carolina,_1990	afterelection
do you know what is the honorary suffix of The leader of NER	london_local_elections,_2018	leader	title#0
do you know what NER's eponymous job is	cori_(lunar_crater)	eponym
what is the currency used in Events in NER, a geographic object?	karelian_autonomous_soviet_socialist_republic	commonlanguages#0	minority
where is the province of The name of the ship from NER	italian_cruiser_vittorio_veneto	shipnamesake	provinceprovince
do you know what is west in NER County, a town and civil parish in devon, united kingdom?	salcombe	shirecounty	west
do you know who the parents of NER's ship name are	hms_hecate_(1871)	shipnamesake	parents#1
do you know which stadium hosts the NER South	2010–11_queens_park_rangers_f.c._season	stadium
who are the descendants of Events in NER	gurjara-pratihara	event	issue#0
what is the final event of NER's name ship, a 1915 queen elizabeth-class battleship of the royal navy?	hms_malaya	shipnamesake	commonlanguages
where is the Alma Mater from NER's ship name	uss_nitze	shipnamesake	title#1
do you know what the profession of Election is after NER	united_states_senate_election_in_north_carolina,_1998	afterelection
what is the honorary suffix of Generals of the participating NERs	battle_of_long_point	commander	awards
what is the era of the NER name	empedocles_(volcano)	type
do you know who NER's Client was before	royal_palace_of_ficuzza	client
do you know who will be the next NER's ship's name, a Benson-class destroyer?	uss_charles_f._hughes_(dd-428)	shipnamesake	after
where is the alma mater of Persons Affected by an NER	alain_badiou	maininterests
what is the next term of the NER era, a precursor of the united kingdom of the netherlands from 1813 to 1815?	united_netherlands_sovereign_duchy	governmenttype
do you know NER manager business type	vodacom_cup	sponsor	companytype
who is the Prime Minister of NER's parents, an Irish politician?	francis_russell,_marquess_of_tavistock	parents	monarch#0
what is the nationality of Election after NER	civic_democratic_party_leadership_election,_1997	afterelection
what is the rank of people, things and things with the same name as NER?	german_destroyer_mölders	shipnamesake	rank
what party belongs to NER's parents	didit_hediprasetyo	education	timezone
do you know what is the southeast of the largest city in NER, a federated state of brazil?	mato_grosso	seat	southeast
do you know what happened during the NER ship name	french_ironclad_alma	shipnamesake
do You Know who Is The Mentor Of NER's Notable Works	khalid_siddiqui	notableworks
where is the title of The leader of NER, a general election of Spain?	spanish_general_election,_1869	leader	before
where is the location of the NER Client	ira_goldstein	client
who is the predecessors of Election after NER	republic_of_china_presidential_election,_1918	afterelection
who is the monarch whose leader is The name of the ship of NER	hmcs_carleton	shipnamesake	after#1
what is the Royal Family of NER Client, a historic building in Corleone, Italy?	royal_palace_of_ficuzza	client
what is the organizational model of the municipal management of the The name of the ship of NER	hmcs_sherbrooke	shipnamesake	governmenttype
what is the honorary prefix of Generals of the participating NERs	battle_of_varese	partof	partof
do you know what is establishedEvent in NER country	bled_castle	locationcountry	southwest
in which country is the Alma mater of NER, a politician?	edward_mcalexander	almamater	country
do you know which league NER team one season football team will play in?	1923–24_atromitos_f.c._season	team
what are the important positions of Election after NER	northern_cyprus_presidential_election,_2015	afterelection
do you know who is the responsible editor of NER	armageddon_(2008)	stip
what is the era of The Winner of NER, A Battle of the American Civil War?	first_battle_of_newtonia	result	era#0
what is the profession of NER's name	list_of_awards_and_nominations_received_by_craig_david	name	profession
From what era did the The leader of NER come	dervish_state	leader
who is the creator of The NER Related Thing	supergirl_(tv)	company	owner
do you know where the head of NER, a state, died?	government_of_national_salvation	era
do you know what is establishedEvent in NER Homelands	igor_cvitanovic	countryofbirth	southwest
do you know where the origin of the name of the NERdied	lippershey_(crater)	eponym
what is the house of The descendant of NER	belengalia_(castile)	predecessor	house
what is the time zone used by Northwest of NER	torres_de_segre	nw	timezone1dst
do you know who is the wife of NER's ship name	french_ship_alexandre_(1857)	shipnamesake	religion
who is the predecessor of Events in NER, an indian dynasty that ruled much of northern india from the mid-8th century to the 11th century?	gurjara-pratihara	event
what happened in The Winner of NER, A Battle of the American Civil War?	first_battle_of_newtonia	result	event#0
where is the location of NER's Alma mater	phil_bentley	almamater
what is the time zone used by NER ship name	hmcs_wetaskiwin	shipnamesake	timezone
do you know who is the leader of the The leader of NER	michael_ellis_(british_politician)	leader
do you know what religion the person who affects NER believes, an italian general, patriot and republican?	giuseppe_garibaldi	honorificprefix
what are the children of NER Parents, a mythical character?	neleus	parents	children#2
what is the type of The province where the NER is located	kallazhagar_temple	state/province	type#0
do you know what the royal family belonged to NER's ship name	rv_kronprins_haakon	shipnamesake	royalhouse
who is the president of the head of NER, a wwf's 1994 summerslam pay-per-view?	summerslam_(1994)	sponsor	chairman
what is the famous eponymous work of NER	boltzmann_(crater)	eponym	workinstitution#2
do you know who is the heir of The leader of NER	colony_of_greenland_(1950–53)	leader
do you know who is the father of Events in NER, an indian dynasty that ruled much of northern india from the mid-8th century to the 11th century?	gurjara-pratihara	event
do you know who Next to NER, a japanese general and war criminal, is loyal to?	takashi_sakai	office
where is the administrative center of NER South	garrigues_(comarca)	seat
where does the religion of Election after NER come from	united_states_senate_election_in_nebraska,_2002	afterelection	religion
do you know who will be the next Customer of NER	royal_spring,_warsaw	client	predecessor	succession
do you know where is the birthplace of NER's ship name	otto_hahn_(ship)	shipnamesake	birthplace#0
do you know where is the birthplace of The father of NER	dongfu_see_ciqia	father	fatherofwife
do You Know where NER Related Things Come From	axe_(brand)	currentowner
what is the type of Theme of NER, an area in universal studios japan?	the_wizarding_world_of_harry_potter_(universal_studios_japan)	theme	genre#1
do you know who is the regent of Les enfants du NER, a British politician (1836-1914)?	joseph_chamberlain	children	primeminister	monarch
do you know what language is used in NER's ship name	mf_tysnes	shipregistry
what are the countries of NER's name, a wikimedia list article, participating?	germanic_wars	name
do you know who is the president of Alma mater of NER	shin_chang-jae	almamater
do you know who is the NER Theme Mentor	skull_island:_reign_of_kong	designer
do you know what is the description of the map of NER's ship name	french_ship_polyphème_(1815)	shipnamesake
do you know what is the title of Nickname of NER	si_xi	nickname	title#3
what is the predecessor of Parents of NER	jawaharlal_nehru	children	before#1
do you know what is the battle of The name of the ship of NER, an udaloy-class destroyer of the russian navy?	russian_destroyer_marshal_shaposhnikov	shipnamesake	battles#0
do you know what is the eponymous type of NER	bolsena_lacus	eponym	type
what is the type of parts of The sea around the NER	milos	archipelago	type
who was the person or things that share the same name with NERavant	cornwallis_(1787_ship)	shipnamesake
who is the cast member of NER's Theme, a 2016 ride at universal's islands of adventures?	skull_island:_reign_of_kong	designer
do you know where is the heir of Generals of the participating NERs	battle_of_legnano	commander	successor
do you know where the capital of NER's ship name is	hms_st._helena_(k590)	shipnamesake	establishedevent#2
do you know what is the problem of Generals of the participating NERs	the_battle_of_dingtao_(eastern_han_dynasty)	commander	issue#5
what is the origin of Famous Works of NER	meyer_amschel_rothschild	religion
where is the description of The area where NER, a language of the baekje kingdom in ancient korea, is used?	baekje	commonlanguages
What's before Generals of participating NERs	u.s._southern_command	commander	awards
who is the predecessor of Beside NER	felix_chung	predecessor#1
do you know who is the mentor of the NER team	red_bull_rb12	team	director
what are the important positions of Beside NER	hyon_yong-chol	alongside	1namedata	branch
do you know what is the maker of NER-related things, a practical model von nokia?	nokia_e5-00	related	manufacturer	locationcountry
do you know which national team belongs to NER South	seattle_sounders_fc_2	s
where did Election die after NER, a wahl?	haitian_presidential_referendum,_1961	afterelection
who is the source of NER's eponymous information?	penticton_(crater)	eponym	subdivisionname
do you know who are the generals involved in the Master of NER	ins_trata	controlledby	commander#1
what is the predecessor of The Descendant of NER	belengalia_(castile)	predecessor
do you know where is the eponymous title of NER	haldane_(lunar_crater)	eponym	title
who influenced Client de NER, an architectural structure in city of edinburgh, scotland, uk?	ramsay_garden	client	almamater
where is the NER Client title	royal_spring,_warsaw	client	title
do you know what is the name of the administrative district of Southern NER	vall-llobrega	s
what is the level of management in Northwest of NER, a municipality in the comarca of osona in catalonia, spain?	gurb	w
do you know where is the eponymous address of NER	cori_(lunar_crater)	eponym
where does the religion of Cities affected by NER come from?	2006_yogyakarta_earthquake	countriesaffected	subdivisiontype
do you know where the artist who sings for NER is spoken	languages_of_papua_new_guinea	extra	nation	legislature
do you know who is next to the NER children	joseph_chamberlain	title
do you know which domain belongs to The name of the ship from NER	akademik_lomonosov	shipnamesake	workplaces
what is the name of the administrative division of the province where the NER is located	khökh-adar_mine	country
do you know where is the region of The province where the NER is located	alderley_edge_mines	state/province	region
where is the position of the Events in NER	empire_of_china_(1915–16)	event
do you know what religion believes in The main organ of NER chiefs	governor_of_genoa	body	religion
do you know what the problem of The Descendant of NER is	leopold_iv,_duke_of_anhalt	issue#0
what is the rank of Election after NER?	guatemalan_general_election,_2011	afterelection	title
who is the mother of The leader of NER	albanian_kingdom_(1928–39)	religion#0
what religion Does NER, an algerian footballer, come from?	rhones_garvay	cityofbirth	timezone
do you know what type of settlement is in the province where NER mine in mongolia is located?	khuut_coal_mine	state/province	seat
do you know who is the predecessor of The name of the ship of NER	uss_windom_(1896)	shipnamesake	before#1	predecessor
do you know what the program format of Notable Works of NER is?	aleks_krotoski	notableworks	format
what is the birthplace of Generals of participating NERs	second_rif_damascus_offensive	commander
do you know where the birthplace of Persons affected by an NER is?	bernard_lewis	maininterests
what is the honorific suffix of Election after NER, a by-election in New Zealand?	rangitikei_by-election,_1880	afterelection	honorificsuffix
where is the burial Place of NER's descendant	ramiro_i_of_asturias	placeofbirth
do you know who is the chief of the area where NER, a language of the baekje kingdom in ancient korea, is used?	baekje	religion#1
what is the status of Participating NER Country	battle_of_chiayi	combatant	commonlanguages
do you know what is the source of the Country of NER, a middle-earth, participant?	battle_of_bangorach	combatant
who Influenced NER's Ship Name	ms_henrik_ibsen	shipnamesake	influenced#2
what is the type of NER addition	i'm_so_sorry	format
do you know what Election run agency is after NER	german_federal_election,_1920	afterelection
do you know which party belongs to NER ship name	usrc_bibb_(1843)	shipnamesake	party
do you know who will be the next Election after NER	french_legislative_election,_1893	leader
who is the architect of the The name of the ship of NER	osterley_(1780_eic_ship)	shipnamesake
do you know when the NER Timeline came from	can_i_borrow_a_dollar%3f	chronology	format
do you know what is setEvent to the area where NER, a language, is used?	ongota	states	label#4
do you know where the alma mater of Election is after NER	united_states_senate_election_in_north_carolina,_1998	afterelection	almamater#0
do you know what is the country of NER Client	warner_elevator_row	client
do you know what is the problem of The winner of NER, a 1106 battle during the invasion of normandy by henry i?	battle_of_tanshebrai	result
what are the awards won by eponym from NER	meitner_(venusian_crater)	eponym	ethnicity
do you know where is the capital of Events in NER	first_hungarian_republic	event	capital
where is NER's eponymous birthplace, a lunar impact crater?	hevelius_(crater)	eponym	religion
do you know who is the head of the The main organ of the heads of NER	governor_of_genoa	body	event
who is the founder of the Master of NER	brownsea_castle	controlledby	founder
what is the label of the area where NER, a language, is used?	ongota	states	label#4
who is the successor of Generals of the participating NERs	the_battle_of_dingtao_(eastern_han_dynasty)	commander	successor
who are the children of the Election after NER, a wahl?	south_korean_presidential_election,_1978	afterelection
what is the era of the Events in NER, a former country?	kingdom_of_galicia_and_lodomeria	event#0	event
do you know what is the name of the administrative district of Northwest of NER	arbúcies	n	e
do you know what the sea is around the NER ship name	uss_tutuila_(arg-4)	shipnamesake
what is the time zone used by NER South	poboleda	subdivisiontype
do you know who is the creator of NER Timeline	it's_a_spongebob_christmas!_album	chronology
what is the subdivisionRanks of The name of the vessel of NER	marsouin_(1788_ship)	shipnamesake
what is the label of L'addition de NER, an album by omarion?	ollusion	extra	label#0
do you know who is the father of NER's ship name	maud_(ship)	shipnamesake	father
who is the NER team manager for fall 2016-2017?	1968–69_fdgb-pokal	team
who is Next to NER's Wife	dong_biwu	premier
do you know who the successor to The NER Related Thing is	sony_xperia_z2a	related	successor	successor
what is the level of management at NER's vessel name	hmcs_peterborough	shipnamesake	postalcodetype
which party belongs Election after NER, a wahl?	united_states_senate_election_in_west_virginia,_2014	afterelection	party
what is the name of the administrative division of The name of the vessel of NER	hmcs_kamloops	shipnamesake	subdivisionname#0	label#4
do you know what is the region of Famous works of NER, a german banker?	meyer_amschel_rothschild	religion
what is the house of The father of NER	princess_huaining	father	succession	incumbent
do you know what is the management level of North East of NER World Day Venue	1993_nba_playoffs	place#1	title
where is the city of The location of The stadium where NER was held, a 30th season of top-tier soccer league in australia?	2006–07_a-league	stadium#1	owner
what is the honorific suffix of Occupied people of The title of NER	peter_mandelson	title#0	appointer	house
who is the head of the Front of NER location	2015_beijing_guoan_f.c._season	stadium#0
do you know what is the postcode of the south west of NER World Day Location	seattle_arctic_drilling_protests	place#0	northwest
what dynasty does The Life of NER World Day Place belong to?	2015–16_fc_barcelona_bàsquet_season	place#0	establishedevent#2
what is the level of management in Northeast of NER's title	drugs,_inc.	title#2	southeast
what is the time zone used by NER's North of Millionaires, a wikimedia listing article?	national_register_of_historic_places_listings_in_davis_county,_utah	city#0	south	timezonedst
what time zone does Northeast of Southeast of NER use?	scofield,_utah	timezonedst
what are the important positions of Name of the leader of The party of NER	perlis_state_legislative_assembly	party#1
do you know who the front of NER's photo caption was before	boston	imagecaption#2
what is the language used in Area covered by the NER location, a football team season?	2016_beijing_guoan_f.c._season	location#5	seat
do you know what is the name of administrative district of Capital of NER location	abu_simbel_temples	location#1
what is the timezone used by Northeast Stadium where NER, an nfl team season was held?	1994_seattle_seahawks_season	stadium#2	timezone
do you know what is the management level of The South of NER World Day Venue	2013_abl_playoffs	place#1	northeast
what dynasty belongs to The Life of NER Site, an American college basketball season?	2015–16_iona_gaels_men's_basketball_team	home#2
do you know what is the name of the administrative district of South East of NER site	2015–16_kentucky_wildcats_men's_basketball_team	home#2	legislature
do you know what is the management level of Western NER location	sabah_international_convention_centre	location#1	northeast
do you know what time zone uses North Western NER, a municipality in gelderland, the netherlands?	oude_ijsselstreek	postalcodetype
do you know what is the name of the administrative district of the South of the West of NER	bicknell,_utah	namedfor
what is the level of management West of South of NER	marysvale,_utah	subdivisiontype#3
do you know what is the management level of Northern Headquarters of NER	canadian_baptists_of_western_canada	headquarters#1	caption
what is the name of the administrative division of South of Southeastern NER, a city in and county seat of millard county, utah, united states?	fillmore,_utah	subdivisionname#1
who is the leader of the Northern NER location	netherlands_at_the_2015_world_speed_skating_championships	location#0
do you know the language family of the common languages of The stage where the NER took place	1972_african_cup_of_nations_qualification	stadium#4
who will be the front of the NER location next	2012_jiangsu_sainty_f.c._season	stadium
what is the name of the administrative division of Le sud de NER, un municipality in baix llobregat, catalonia, spain?	begues	n	w
what is the house of The father of NER	trịnh_tráng	house
do you know what is the name of the administrative district of The Northwest Site of NER, an American college basketball season?	2014–15_utah_state_aggies_men's_basketball_team	home#2
which party belongs to Election after NER	mongolian_legislative_election,_2008	afterelection	1namedata	office#1
who is the father of Regent from The question of NER	princess_maria_pia_of_bourbon-two_sicilies_(1849–1882)	issue#1	father
do you know where NER leader died	french_national_convention_election,_1792	afterelection
do you know what is the succession of L'avant de La question de NER, a last Holy Roman Empress and first Empress of Austria?	maria_theresa_of_naples_and_sicily	succession
what is the ZIP code for the South West location of NER, a football tournament season?	2015_lamar_hunt_u.s._open_cup	location#2	timezonedst
what is the Typical Settlement of Western NER Region	cordillera_central_(luzon)	region#3
do you know what are the subdivision ratings of the NER ship name	uss_torchwood_(an-55)	shipnamesake
do you know who is the wife of Election after NER	united_states_presidential_election_in_wisconsin,_1880	afterelection
do you know where is the title of Election after NER, a wahl?	united_states_senate_election_in_georgia,_2014	afterelection	title#2
what is the name of the administrative division of NER Site West, a season of American college basketball?	2014–15_south_dakota_state_jackrabbits_men's_basketball_team	home#0
what is the time zone used by NER Eastern West	administrative_divisions_of_ilocos_sur	east#0	southeast	southwest
what is the level of management in the Northwest of the Southwest of NER	laketown,_utah	postalcodetype
do you know what is the management level of The northeast of NER's place of death	john_james_joseph_monaghan	deathplace#1
who is the head of the Area covered by the The stadium where the NER took place	2014_malaysia_premier_league	stadium#2
do you know what is the name of the administrative district of Eastern Site of NER, a season of American college basketball?	2013–14_uc_santa_barbara_gauchos_men's_basketball_team	home#0	west	subdivisionname#0
do you know who is next to the Generals of the participating NERs	battle_of_long_point	commander
do you know which national team belongs to The coach of NER's club, a wikimedia list article?	uefa_euro_2016_squads	name#5
What's wrong with The Father of NER	princess_hongnong	father	regent#0
what is the birthplace of The Father of NER	dongfu_see_ciqia	father	fatherofwife
do you know who was the forward of The NER location, a football team season, before?	2014_shanghai_greenland_shenhua_f.c._season	location#2	before	before#1
where is the title of Election after NER	united_states_senate_election_in_south_dakota,_2014	afterelection
what are the important positions of NER's ship name, un barku den noruega?	ms_thorbjørn	shipnamesake	party
what time zone does Northeast of The stadium where the NER took place	2008_seattle_seahawks_season	stadium#0	southwest
do you know what is the name of administrative district of Western NER location	2013–14_gimnàstic_de_tarragona_season	location#1
do you know what country the NER location photo caption is	2016–17_huddersfield_town_a.f.c._season	location#2	currency
do you know what type of The thing related to NER	sony_xperia_z2a	related	type#0
where is the position of the Vessel name of NER	italian_battleship_vittorio_veneto	shipnamesake	place#0	deputy#1
where is the city of The location of The stadium where the NER took place	new_zealand_at_the_rugby_world_cup	stadium#0	location
do you know where is the city of The operator of The stadium where the NER took place	2009–10_ergotelis_f.c._season	stadium#1	operator	ground
who will be Election after NER next	bulgarian_parliamentary_election,_1986	afterelection
do you know what time zone is West of The place of death of NER, a german world war ii stuka pilot and neo-nazi activist?	hans-ulrich_rudel	birthplace
do you know who is the wife of Election after NER	south_korean_presidential_election,_1978	afterelection
do you know what timezone the Northeast of The stadium where NER took place, a 38th season in franchise history; first super bowl win?	2013_seattle_seahawks_season	stadium#0	southwest
who is the predecessors of The leader of NER	mongolian_legislative_election,_2016	beforeelection	president
do you know what is the management level of Area covered by the NER location	1994–95_wolverhampton_wanderers_f.c._season	location#1	caption
What's before Generals of participating NERs	boundary_river_battle_(anti-japanese_war)	commander	deathplace
do you know what time zone uses The province where the NER is located	dhua_kund	state/province	timezone
what is the name of the administrative division of the southwest of NER's location	2011–12_az_alkmaar_season	location#1	legislature	house#1
do you know who was the Front of World NER Day Venue before	2016_cba_playoffs	place#0
do you know what currency is used in NER Location Release Event	2014_davis_cup_americas_zone_group_i	venue#0
what Happened in the Time of NER's Ship's Name	russian_ship_of_the_line_gangut_(1825)	shipnamesake	place#0	southwest
what is the name of the administrative division of Southern Eastern NER, a town in millard county, utah, united states?	kanosh,_utah	namedfor
do you know who is the heir of Occupied people of The title of NER	margaret_beckett	successor#0
what time zone uses North of The place of death of NER, a medal of honor recipient?	henderson_c._howard	deathplace#1
do you know what time zone uses West of Southwest of NER	rotterdam	timezonedst
what is the time zone used by South of Southeastern NER, a city in and county seat of millard county, utah, united states?	fillmore,_utah	southwest	timezonedst
what is the name of the administrative division of the southwest of the northwest of NER	scofield,_utah	timezonedst
who is the heir to NER's ship name	alfa_nero	shipnamesake	successor
do you know who is the leader of the South of NER site	2014–15_santa_clara_broncos_women's_basketball_team	home#0	west
what condition is NER's ship name an arleigh burke class destroyer in?	uss_carl_m._levin	shipnamesake	state	northwest
what musical instrument did NER's name use	list_of_awards_and_nominations_received_by_billy_ray_cyrus	name
do you know what is the management level of North of Northwestern NER, a town in sevier county, utah, united states?	koosharem,_utah	postalcodetype
what is the Famous Work of NER Client	heathfield_hall	client	workplaces#1
what is the name of the administrative division of The name of the vessel of NER	ins_kavaratti	shipnamesake
what is the common language of the NER Location Release Event	eastern_tepuis	location#1	legislature
do you know what time zone is in Club in which The stadium where the NER took place is part	2006_uefa_european_under-17_championship	stadium#3
what is the name of the southwestern administrative division of NER Millionaires, a wikimedia listing article?	national_register_of_historic_places_listings_in_utah_county,_utah	city#4
what is related to NER's ship name, un barku den estadonan uni di merka?	chilean_brigantine_araucano	shipnamesake	related#1
do you know where is the province of the southwestern Administration of NER	lakawon	countryadmindivisions#1
where does the religion of NER's ship name come from?	usns_john_lewis_(t-ao-205)	shipnamesake	state
do you know where is the title of The name of the ship of NER	cornwallis_(1787_ship)	shipnamesake	honorificprefix
do you know who is the predecessor of The busy people of The title of NER	soong_ching-ling	predecessor	before
do you know who is the leader of the NER's ship name	hmcs_lachine_(j266)	shipnamesake	west
who is the manager of Tenants of The stadium where the NER took place, a football team season, for the fall of 2016-2017?	2012_montedio_yamagata_season	stadium#4
what is the level of management at the South of The stadium where the NER took place	2008_houston_dynamo_season	stadium#0	east
do you know who was the people, things and things with the same name as NER before	spanish_cruiser_don_antonio_de_ulloa	shipnamesake
do you know where the birthplace of NER's Coach is?	hafez_hashim	coach
do you know who is the predecessor of The name of the ship of NER	usrc_mclane_(1832)	shipnamesake	title
what is the education level of The addition of NER, a 2013 south korean romantic melodrama television series?	that_winter,_the_wind_blows	writer
do you know who is the Premier agent of NER Predecessor, a Taiwanese politician?	yu_shyi-kun	president
do you know what is the name of the administrative district of the south of the south-west of NER	clarkston,_utah	southwest#1	subdivisionname#1
do you know what is the management level of Southern Place of NER	2003_iwcc_trophy	venue#1	postalcodetype
do you know where is the birthplace of the city of Captain of The club of NER	2005_fifa_world_youth_championship_squads	club#0
do you know who was the Your next club L'avant de NER, a French politician (1885-1956), before?	yvon_delbos	before#3
what is the royal family of The name of the ship of NER	ss_prinses_astrid	shiproute
what is the national team of The coach of The club of NER, a wikimedia list article?	2015_fifa_u-17_world_cup_squads	club#0	ground
who are the children of NER's name	hades_in_popular_culture	name
who is the mother of Your next club The question of NER	juan_carlos_i_of_spain	issue#0	religion
do you know who is the predecessor of Election after NER	italian_general_election,_1992	afterelection	appointer	predecessor
do you know who is the leader of the Publication event of NER location, a gebeurtenis to jaar?	2012–13_in_argentine_football	location#0	legislature
do you know what is the occupation of Chronology of NER, a 2001 album?	themes_from_calmi_cuori_appassionati	chronology	profession#2
do You Know which Party Belongs to NER's Location Life	polonia_(train)	operator
who was the person or things that share the same name with NERavant	hms_tarleton_(1782)	shipnamesake
do you know what is the management level of The Northeast Site of NER, an American college basketball season?	2016–17_idaho_vandals_men's_basketball_team	home#1	southeast
do you know what are the subdivision ratings of the NER ship name	hms_falcon_(1820)	shipnamesake
do you know what state is East of NER location	2011–12_tsw_pegasus_fc_season	location#1
do you know who is the predecessor of Your next club L'avant de NER, a French politician (1885-1956)?	yvon_delbos	before#1	predecessor
do you know what is the management level of The South of NER location, a wikimedia list article?	list_of_cultural_properties_of_the_philippines_in_calabarzon	location#0
who is the leader of the Northeast NER location	2013_kashiwa_reysol_season	stadium#0
what is the title of The Descendant of NER	jizen_pema	religion
do you know what is the management level of The Northeast of NER Millionaires, a wikimedia list article?	national_register_of_historic_places_listings_in_los_angeles_county,_california	city#1	northeast	southeast
which party belongs to Election after NER	national_liberation_party_presidential_primary,_2009	beforeelection	party
who is the leader of the East of The stadium where the NER took place	2013_afc_champions_league_knockout_stage	stadium#0
do you know where the constituency of the West of NER's place of death is	joost_de_blank	deathplace#1
In what condition is NER's Alma mater	peter_bramley_(biochemist)	almamater	president
do you know where the Northeast of NER's location is, a football team season?	2013–14_south_china_aa_season	location#2
do you know where is the constituency of the North of NER location, a football team season?	2011–12_portsmouth_f.c._season	location#2	settlementtype
where is the city of The operator of The stadium where the NER took place	2008–09_coventry_city_f.c._season	stadium#0	legislature
do you know what is the management level of NER south	garrigues_(comarca)	seat	subdivisiontype
what is the level of management in Area covered by NER Region	sudan_revolutionary_front	area#1	subdivisiontype
do you know where is the city of Alma mater de NER, an american football coach?	bob_padilla	almamater
do you know what is the name of the administrative district of Nord-Ouest de NER, a municipality in Flemish Brabant, Belgium?	pepingen	nw	n
do you know what important positions Election has after NER	lithuanian_parliamentary_election,_2000	afterelection
what is the level of management at Southwest NER South, a town in piute county, utah, united states?	marysvale,_utah	subdivisiontype#2
what is the next term of the NER national team club	sebastian_meyer	clubs
who are the parents of NER's ship name	uss_joseph_p._kennedy_jr._(dd-850)	shipnamesake	religion
what is the western national team location of NER, a hong kong association football player?	peng_zijian	nationalteam	location#2
do you know who is the mentor of the NER addition	3/8_(album)	extra	studio
do you know what is the management level of NER ship name	hmcs_parry_sound	shipnamesake	subdivisiontype#2
do you know what time zone Southwest of North NER, a town in utah county, utah, united states uses?	goshen,_utah	timezonedst
who is the heir of Election after NER	iranian_legislative_election,_1956	beforeelection	predecessor	after
where is the address of the NER team	1986_paraguayan_primera_división_season	team
do you know who is the leader of the NER's ship name	russian_submarine_severodvinsk_(k-329)	shipnamesake	leadername
do you know where the constituency of the West Venue of NER, a sportseizoen van een cricketcompetitie, is?	1993_women's_cricket_world_cup	venue#0	northwest
do you know what timezone uses Southwest from NER West	loa,_utah	timezonedst
what is the NER Location Release Event	2015_la_galaxy_season	location#2
do you know what kind of NER addition	i'm_so_sorry	format
what is the ideology of NER's ship name, a russian cruiser?	soviet_cruiser_komintern	shipnamesake	ideology#0
what is the level of management West of NER's place of death	john_wainwright_(medal_of_honor)	deathplace#1
do you know what is the name of the administrative district of NER Millionaires South, a mountain range in millard and sevier counties in utah, united states?	pavant_range	city#0
do You Know where Your Next Club from The NER Question Died	blanche_of_namur	issue#0	regent
what language does NER addition, a 2013 south korean romantic melodrama television series use?	that_winter,_the_wind_blows	nextshow	nextshow	nextshow#1
do you know what time zone uses NER South	osor,_girona	nw	subdivisiontype
what musical instrument did NER, a sovereign state in south america, use?	heart_&_soul_(ron_carter_and_cedar_walton_album)	chronology
do you know what is the program format of The title of NER World Day Venue?	2016_cba_playoffs	team#1
what is the type of division of The North of City of birth of NER	robino	cityofbirth	north#2	subdivisiontype#1
do you know who was touched by NER's eponymous	mach_(crater)	eponym
what is the name of the administrative division of the North of The stadium where the NER took place	2013_st_helens_season	stadium#0
what is the name of the administrative division of Eastern NER Millionaires, a wikimedia listing article?	national_register_of_historic_places_listings_in_wasatch_county,_utah	city#1	subdivisionname#1
where is the title of Your next club The question of NER	mary_of_hungary,_queen_of_naples	issue#0	title#0
do you know what is the name of administrative district of West of NER site	2014–15_utah_state_aggies_men's_basketball_team	home#2
what is the name of the administrative division of the southwest of The stadium where the NER, a football team season, took place?	2009–10_al_ain_fc_season	stadium#1
do you know who is the president of the Tenants of The stadium where the NER took place	2011_emperor's_cup	stadium#3
do you know what is the name of the administrative district of the south-west of The stadium where the NER took place, a gebeurtenis in jaar?	2011–12_in_french_football	stadium#7
what is the type of The name of NER	list_of_awards_and_nominations_received_by_lorde	name
who is the president of Alma mater de NER, a chinese actress?	deng_jiajia	almamater	president
do you know what is the management level of Western NER Millionaires	cbu-fm	city#0	subdivisiontype#2
do you know what is the common language of the NER Location Release Event	colombia_national_football_team_results_(2000–19)	location#5
do you know what is the name of the administrative district of The Northwest of NER Millionaires, a wikimedia list article?	national_register_of_historic_places_listings_in_king_county,_washington	city#2
who is the wife of The next term of The question of NER, an heir apparent to the Margraviate of Baden?	charles_louis,_hereditary_prince_of_baden	issue#0	next	spouse
do you know what time zone uses Club in which NER location, a football team season, is part?	2011–12_lleida_esportiu_season	location#0	w	n
do you know who is the predecessor of The name of the ship of NER	french_cruiser_georges_leygues	shipnamesake	predecessor	predecessor
do you know who was the Election after NER before	spanish_general_election,_1931	afterelection
who is the heir to NER's ship name	egyptian_sloop_el_amir_farouq	shipnamesake	issue#1	after
what is the northeast location of NER's national team, an association football player?	lin_xiaocheng	nationalteam	stadium#0
do you know what is the traditional shape of the forward of NER's club?	2016_afc_u-23_championship_squads	name
who is the leader of the East of The stadium where the NER, an international football competition, took place?	2002_fifa_world_cup_qualification_–_afc_first_round	stadium#0
what eponymous domain of NER belongs to	d'alembert_(crater)	eponym
do you know who was the front of NER's location before	australia_women's_national_soccer_team_results_(2000–09)	location#2
where are the heirs of Generals of the participating NERs	battle_of_baiteng_river_(938)	place	legislature
do you know what is the rank of Next to NER	takashi_sakai	rank
do you know where is the city of Alma mater from NER	wayne_chabre	almamater	state
who is the heir to the front of NER's title	the_complete_guide_to_everything	title#11
do you know who the generals involved in the NER ship name are	french_ironclad_marengo	shipnamesake	commander
do you know where is the city of Alma mater from NER	ed_jackson_(tennessee_politician)	almamater
what is the time zone used by Eastern of Southern NER	molenwaard	southwest
what is the famous eponymous work of NER	viviani_(crater)	eponym
who are the people affected by NER's ship name, a container ship?	cma_cgm_alexander_von_humboldt	shipnamesake	influences	almamater#2
what are the awards won by The first of The title of NER	john_m._loh	title#0	first	awards#1
what is the traditional shape of the forward of NER's club	2016_afc_u-23_championship_squads	name
what is EstablishedEvent at NER Country	international_association_of_inventions'_unions	locationcountry
do you know what are the subdivision ratings of the NER ship name	hms_jaseur_(1807)	shipnamesake
who is the leader of the Northwest NER location	2015–16_in_hong_kong_football	location#0	legislature	leader#2
do you know where the religion of The name of the ship of NER, an italian line passenger ship, comes from?	ms_giulio_cesare	shipnamesake	birthplace
do You Know what Language Lyrics Of NER's Title Is Using	the_beat_goes_on_(super_junior_d&e_album)	music
do you know who is the predecessor of The name of the ship of NER	french_ship_alexandre_(1857)	shipnamesake	succession
do you know what awards the person or things that share the same name with NER, a canadian forces naval reserve unit based in ottawa, ontario, won?	hmcs_carleton	shipnamesake	honorificprefix#1
what are the eponymous prizes won by NER, a lunar impact crater?	fermi_(crater)	eponym	awards#3
what is the next term of the father of NER, a son of emperor go-murakami?	prince_weicheng	father	after	after
do you know what is the title of the seats of the location of the National team of NER, a footballer?	heinrich_schmidtgar	currentclub
who was the Predecessor of L'avant de NER before	pierre_pflimlin	before#1
what is the name of the administrative division of Southern NER	vilallonga_de_ter	s
who is the predecessors of The Parents of NER	francis_russell,_marquess_of_tavistock	parents	predecessor#0
do you know what is the district of The main city of NER, a canton of France?	canton_of_moreuil	chieftown
do you know what the profession of NER addition is?	boysitter	extra
what is the level of management at NER South	la_nou_de_gaià	subdivisiontype
what are the important positions of Beside NER, a hong kong politician?	felix_chung	occupation#1
do You Know who Will Be Next The Ahead Of NER's Question	archduchess_maria_beatrix_of_austria-este	issue#1
do you know what time zone uses Southeastern NER location a football team season?	2012_santos_fc_season	location#1
where does the religion of Election after NER come from	labour_party_(uk)_deputy_leadership_election,_2015	afterelection	honorificsuffix
do you know where NER's The Name of the Ship takes place?	russian_ship_of_the_line_gangut_(1825)	shipnamesake	place#0	southwest
do you know who is the leader of the Eastern NER location	2014–15_bengaluru_fc_season	location#0	west
what is the name of the administrative division of Southern NER County, a wikimedia listing article?	list_of_national_historic_landmarks_in_massachusetts	county#0
do you know where is the address of the tenants of the stadium where the NER took place, a football team season?	2015–16_atlético_madrid_season	location#2	legislature#0
do you know what is the specialty of Inaugural speech of The title of NER, a former general secretary of the Lao people's revolutionary party (2016-2021)?	bounnhang_vorachith	party
what are the important positions of Election after NER, a wahl?	united_states_senate_election_in_north_carolina,_1998	afterelection	occupation#1
what is the name of the administrative division of Southern Site of NER	2014–15_washington_huskies_women's_basketball_team	home#0	northwest
do you know where the religion of NER's ship's name comes from	french_ship_charlemagne_(1852)	shipnamesake	religion
where is the Alma Mater of Election after NER, a wahl?	united_states_senate_election_in_west_virginia,_2014	afterelection
do you know who is the leader of the The North West of The stadium where the NER took place, a sportseizoen van een voetbalcompetitie?	2013_afc_champions_league_group_stage	stadium#0	south
do you know where the Northeast of NER site is, an intercollegiate basketball season?	2016–17_houston_cougars_women's_basketball_team	home#0	south	southeast
do you know who is the leader of The life of The stadium where the NER took place, an nfl seasonal playoff games?	2013–14_nfl_playoffs	stadium#3	legislature	leader#1
what is the level of management at NER South	puiggròs	subdivisiontype
what is the common language of the NER Location Release Event	2010–11_c.d._motagua_season	location#4	seat
In what state is The name of the ship from NER	japanese_cruiser_mogami_(1934)	shipnamesake
where is NER's eponymous death place	barringer_(lunar_crater)	eponym
what is the name of the administrative division of Birthplace of L'avant de NER, an american comics writer?	karl_kesel	before#1	birthplace	subdivisionname#1
do you know what is the famous work of NER's eponymous	eijkman_(crater)	eponym
do you know what is the name of the administrative district of The Northeast of The stadium where the NER took place	2017_world_men's_handball_championship_–_european_qualification	stadium#0	timezonedst
do you know what is the name of the administrative district of Western NER Millionaires, a wikimedia list article?	national_register_of_historic_places_listings_in_cache_county,_utah	city#2
in which state is the Area covered by the NER location, a football team season?	2014_shanghai_greenland_shenhua_f.c._season	location#2
do you know who is the mother of NER's ship name	french_frigate_cléopâtre_(1781)	shipnamesake	regent#2
do you know that before the person or thing related to the result caused by NER is?	battle_of_huoyi	result
do you know where is the title of Inaugural Speech of The title of NER, a British politician (born in 1943)?	margaret_beckett	title#6	appointer
do you know who is the head of the The head of the NER	scottish_conservative_party	chairman
do you know where is the administrative center of the province where the NER is located	chandgana_tal	state/province	seat	subdivisionname
do you know what is the title of The winner of NER, a 1106 battle during the invasion of normandy by henry i?	battle_of_tanshebrai	result
what is the time zone used by The North West of the South West of NER	emery,_utah	timezonedst
what is the level of management at NER's Southeast Site, an intercollegiate basketball season?	2011–12_byu_cougars_women's_basketball_team	home#1	southeast	subdivisiontype#3
what Happened in the Time of NER's Ship's Name	french_ship_rivoli_(1810)	shipnamesake	place#0
what is the Model Regulation of The province where the NER is located	koksay	state/province	settlementtype
do you know where is the address of The operator of The stadium where the NER took place, a football team season?	2012–13_paok_fc_season	stadium#0	operator	ground
do you know who is the president of NER's ship name	uss_windom_(1896)	shipnamesake
do you know who is the predecessor of Inaugural speech of The title of NER	milton_obote	after
do you know what time zone is in East of NER location, a football team season?	2010–11_valencia_cf_season	location#1	settlementtype
what is the nationality of Election after NER	brazilian_presidential_election,_1960	afterelection
what are the products of The owner of NER's club, a wikimedia list article?	baseball_at_the_2008_summer_olympics_–_team_squads	name
what is related to responsible for NER	coca-cola_topnotchers	sponsor
do you know what is the name of the administrative district of The North of NER Millionaires	national_register_of_historic_places_listings_in_davis_county,_utah	city#2	subdivisionname#1
where is NER's eponymous Alma Mater	harden_(crater)	eponym	almamater#0
where is the administrative center of Western NER County	hurricane_rita_tornado_outbreak	county#3	namedfor
who are the descendants of NER's ship name	french_frigate_cléopâtre_(1781)	shipnamesake	regent#1
do you know who the person or things that share the same name with NER, a ship, were before?	french_cruiser_georges_leygues	shipnamesake	after#3
do you know where is the title of Election after NER	cape_verdean_parliamentary_election,_2016	beforeelection	title
where Does the Religion of Inaugural Speech from NER's Title Come From?	josé_luis_rodríguez_zapatero	title#0	inaugural	religion
which party belongs to The life of The stadium where the NER took place	2010–11_in_australian_soccer	stadium#2
do you know which party belongs to NER ship name	usrc_mclane_(1832)	shipnamesake	title
what is the time zone used by the NER Southwest Site, an American college basketball season?	2014–15_byu_cougars_men's_basketball_team	home#2	southwest	timezonedst
do you know who was the Election after NER before	french_legislative_election,_1914	afterelection
do you know what time zone is in South of NER, a village in the province of girona and autonomous community of catalonia, spain?	vall-llobrega	subdivisiontype#1
To which party belongs The name of the ship of NER	uscgc_dallas_(whec-716)	shipnamesake	party
do you know what type of zoning is at the National team location of NER, an estonian association football player?	ragnar_kravan	clubs#1
do you know where is the city of The location of Birthplace of NER	junior_paulo_(rugby_league,_born_1993)	birthplace#1	legislature
what is the level of management at West of NER's location, a wikimedia listing article?	list_of_national_cultural_treasures_in_the_philippines	location#2
who are the NER eponymous affected people	protagoras_(crater)	eponym	birthplace#1
what is the name of the administrative division of the Southeast of NER site	2014–15_gonzaga_bulldogs_women's_basketball_team	home#2
do you know what is the name of the administrative district of The Northwest Site of NER, an American college basketball season?	2015–16_utah_state_aggies_men's_basketball_team	home#2
who is the predecessors of The leader of NER	dokumacılar	country	legislature
what is the level of management at Country Capital to which NER belong	trujillo_state_anthem	country#1	establishedevent	governmenttype
what is the level of management at NER's West of Photo Caption, a genus of insects?	tanaecia	imagecaption#0	southwest
what is the level of management at NER's North West Site	2011–12_ucla_bruins_men's_basketball_team	opponent
