where is the constituency of the one who is alongside NER from?	Zhong_Guobin	alongside	educationlevel
who is the successor of the parent of NER	Frank_Russell,_2nd_Earl_Russell	parents	successor
who is the leader of the administrative region to which NER belongs?	Governor_of_Genoa	body	leader
who preceded the parent of NER	Franklin_Delano_Roosevelt_III	parents	parents
which draft team does the author of NER dj quik, lord tariq and peter gunz, belong to?	The_Way_It's_Goin'_Down	chronology	position
who is before the parent of NER statesman, and writer, first prime minister of india (1889-1964)?	Jawaharlal_Nehru	children	before
where does the location province of NER belong to?	Khuut_coal_mine	state/province	seat
who does the origin of NER influence's name?	Aryabhata_(crater)	eponym	region
what is the genre of the author of NER	They_All_Went_to_Mexico	chronology	genre
which title does the parent of NER belong to?	Franklin_Delano_Roosevelt_III	parents	title
what is the parent mountain of the client of NER?	Goldstein	client
who did a job before the parent of NER?	Frank_Russell,_2nd_Earl_Russell	parents	predecessor
what is the type of the people, things and things with the same name as NER?	Kilauea_Volcano	shipnamesake	type
what is the profession of the one that is after election of NER?	Italian_general_election,_1992	afterelection	profession
who is the creator of the car that NER is related to?	Supergirl_(TV_series)	related	teleplay
who is before the commander of NER?	U.S._Southern_Command	commander	cteam
who did a job before the one that is after election of NER?	Republic_of_China_presidential_election,_1918	afterelection	predecessor
what is spoken by the name included in the NER?	List_of_awards_and_nominations_received_by_Craig_David	name	language
who married the author of NER	Christmas_Together	chronology	spouse
what is the nationality of the name included in the NER?	List_of_awards_and_nominations_received_by_Craig_David	name	nationality
where is the people, things and things with the same name as NER located?	John_Spaldon_Lewis	shipnamesake	state
who wrote the singer who performed for NER?	5_(album)	extra	studio
which one is known as the prime minister of the one that is after election of NER	Peruvian_general_election,_1985	afterelection
where is the team that won NER grounded?	1955–56_Hapoel_Haifa_FC_season	team	other
who rules the commander of NER	Battle_of_Legnano	commander	regent
where is the headquarters of the combatant of NER	Civil_War_in_the_Republic_of_Congo	combatant	headquarters
what is the title of the eponym of NER?	Haldane_(lunar_crater)	eponym	title
who is the leader of the combatant of NER?	grief_night	combatant	leader
what is the religion of the event happened in NER?	upper_germania	event	religion
what is the house of the commander of NER?	Battle_of_Shirateng_River_(938)	commander	subdivisiontype
where does the one that is after election of NER belong to?	German_federal_election,_1920	afterelection	deathplace
who is the successor of the leader of NER?	University_of_Greenland	leader	successor
which dynasty does the leader of NER belong to?	spanish_national_railway	leader	house
what is the job of the people, things and things with the same name as NER?	Type_13_ship_attack_aircraft	shipnamesake	profession
who starred in the sponsor of NER	Night_of_Champions_(2012)	sponsor	format
which religion does the country that is affected by NER belong to?	2008_Pakistan_Earthquake	countriesaffected	religion
what is the location of the alma mater of NER?	Walter_Owen_Bentley	almamater	location
what is involved in the important events attended by NER?	Queens_Park_Rovers_2010-2011_season	s	team
what does the people, things and things with the same name as NER belong to?	French_ironclad_Alma	shipnamesake	partof
what is the succession of the commander of NER?	Battle_of_Legnano	commander	succession
who published the sponsor of NER?	Armageddon_(2008)	sponsor	publisher
what belongs to the parent of NER	Neleus	parents	children
where is the author of NER born?	The_Milt_Jackson_Big_4	chronology	birthplace
what is the region of the location province of NER?	Alderley_Edge_Mines	state/province	region
what causes the people, things and things with the same name as NER?	Greek_Post	shipnamesake
where is the people, things and things with the same name as NER buried?	French-Dutch_War	shipnamesake	burialplace
which party does the parent of NER belong to?	Didit_Hediprasetyo	parents	party
which place is called as the subdivision of the location province of NER?	Khokh-Adar_mine	state/province	subdivisionname
what is on the south of the people, things and things with the same name as NER?	Suppress_enemy_air_defense_missions	shipnamesake
which war is included in the era of the people, things and things with the same name as NER?	British_Malaya	shipnamesake	era
who is the leader of NER?	House_of_Assembly_of_Saint_Vincent_and_the_Grenadines	leader	monarch
who is the regnet of the children of NER	Joseph_Chamberlain	children	regent
who is the descendant of the successor of NER?	Leopold_IV_(Anhalt)	issue	issue
which series does the sponsor of NER belong to?	Jive_Records	sponsor
where is the south of the location province of NER	Sakhalin_Region	state/province
who appointed NER's record company?	Permanent_Mission_of_the_People's_Republic_of_China_to_the_United_Nations	label	appointer
what is the title of the successor of NER?	Christoph_(Schleswig-Holstein)	issue	title
what is the party of the one that is after election of NER	United_States_Senate_election_in_West_Virginia,_2014	afterelection	party
where does the one that is after election of NER get the honorific suffix?	Baguio_Legislative_Constituency	afterelection	honorificsuffix
which religion does the one that is after election of NER belong to?	United_States_Senate_election_in_Nebraska,_2002	afterelection	religion
who did a job before NER related events?	Gurjara-Pratihara	event	predecessor
which war is included in the era of the person whose name is used to name NER?	Philolaus_(crater)	eponym	era
who is the manager of the team that won NER?	1968–69_FDGB_Cup	team	manager
who directed the singer who performed for NER?	5_(album)	extra	studio
what lies in the west of the county that NER belongs to?	Salcombe	shirecounty	west
what is the timezong of NER's southern region?	Poboleda	s	n
who is the prime minister of the parent of NER?	Frank_Russell,_2nd_Earl_Russell	parents	primeminister
what is the royal house of the person and things that shares the same name with NER?	Haakon_VI	shipnamesake	royalhouse
what is the status of the country that is spoken NER	Tokelauan	states	status
where did the one who is alongside NER die?	Gordian_I	alongside	deathplace
what is the predecessor of the combatant of NER?	Irish_Civil_War	combatant	almamater
what is the area that the combatant of NER is located in?	Civil_War_in_the_Republic_of_Congo	combatant	area
who is the predecessor of the coach of NER?	Indian_national_football_team	coach	clubs
what does the division that NER belongs to work for?	2009–10_Australian_Professional_Football_League	division	team
who is the father of NER-related event related persons?	Gurjara-Pratihara	event	father
what is the timezong of the northwest of NER?	Gremore_De_Toro	nw	timezone1dst
who is the starring role of the person and things that shares the same name with NER	Dry_Stantine_Ankiel	shipnamesake	starring
who married the client of NER?	Royal_Spring,_Warsaw	client	spouse
who is the starring role of the theme of NER	Hong_Kong_Sheng_Kung_Hui_Diocese_of_Hong_Kong_Island	theme	starring
what is the parts type of the archipelago that NER belongs to?	Milos	archipelago	type
what is the northeast of the county that NER belongs to?	budgers_hill	shirecounty	northeast
what is the origin of NER's name?	Cori_(lunar_crater)	eponym	occupation
what is the instrument that the singer who performed for NER plays?	Ollusion	extra	instrument
who leads the people, things and things with the same name as NER?	British_Malaya	shipnamesake	leader
what is in the east of the county that NER belongs to?	budgers_hill	shirecounty	east
what is the party of the leader of NER?	Provisional_People's_Committee_for_North_Korea	leader	party
where is the birthplace of the coach of NER?	Hafez_Hashim	coach	subdivisiontype
what is the location of the person and things that shares the same name with NER?	USS_Tutuila_(ARG-4)	shipnamesake	location
which country uses the singer of NER	Languages_of_Papua_New_Guinea	extra	fam
who gave birth to the person and things that shares the same name with NER?	HMS_Hecate_(1871)	shipnamesake	parents
who is the spouse of the leader of NER?	Provisional_People's_Committee_for_North_Korea	leader	spouse
which royal house does the client of NER italy, belong to?	Royal_Palace_of_Ficuzza	client	royalhouse
which dynasty does the client of NER belong to?	Royal_Spring,_Warsaw	client	house
where does the person and things that shares the same name with NER belong to?	USS_Winnemucca_(PC-1145)	shipnamesake	settlementtype
who takes the place of the children of NER	Joseph_Chamberlain	children	successor
who does the person and things that shares the same name with NER influence?	Henrik_Ibsen	shipnamesake	influences
what is the currency of the event of NER?	Karelian_Autonomous_Soviet_Socialist_Republic	event	currency
which leader party does the location province of NER belong to?	Sieberstollen	state/province	leaderparty
who is the commander of the people, things and things with the same name as NER?	The_Brig	shipnamesake	commander
where is the client of NER located?	Goldstein	client
who is the successor of the car that NER is related to?	Sony_Xperia_Z2a	related	successor
where is the person and things that shares the same name with NER born?	Otto_Hahn_Prize	shipnamesake	birthplace
what is the language that is commonly used by the combatant of NER?	Battle_of_the_Tisza	combatant	commonlanguages
which religion does the successor of NER belong to?	Jizen_Pema	issue	religion
who is the successor of things related to NER?	HTC_Desire_626	related	successor
which region does NER belong to related events?	List_of_Czech_monarchs	event	territory
what happened in the era of the event of NER?	Kingdom_of_Galicia_and_Lodomeria	event	era
who is the most important people of the controller of NER?	Brownsea_Castle	controlledby	keypeople
which label does the singer who performed for NER belong to?	Ollusion	extra	label
who do the job after the one that is after election of NER?	Brazilian_presidential_election,_1960	afterelection	timezone1dst
where is the person and things that shares the same name with NER buried?	USS_Troup_(1812)	shipnamesake	placeofburial
who leads the country that is affected by NER?	1857_Basilicata_earthquake	countriesaffected	leader
what is the country admin division of the person and things that shares the same name with NER?	Vaygach_(1989_icebreaker)	shipnamesake	countryadmindivisions
who is the creator of the children of NER?	Susan_Mayer	children	creator
which state does the one that is after election of NER belong to?	United_States_Senate_election_in_West_Virginia,_2014	afterelection	state
what lies in the southeast of the largest city of NER?	Mato_Grosso	largestcity	southeast
who takes the place of the coach of NER	Indian_national_football_team	coach	after
which logo is about NER's record company?	I'm_Xiao_Xiao	label
what is the house of the father of NER?	Princess_Huaining	father	focus
what is the occupation of the leader of NER?	French_legislative_election,_1827	leader	occupation
where is the people, things and things with the same name as NER educated?	French_aircraft_carrier_Joffre	shipnamesake	education
who is the creator of the author of NER?	It's_a_SpongeBob_Christmas!_albums	chronology	creator
who is the leader of the leader of NER	Michael_Ellis_(British_politician)	leader	leader
which religion does the eponym of NER belong to?	Born_(crater)	eponym	religion
where is the birthplace of the commander of NER?	Second_Rif_Damascus_Offensive	commander	birthplace
which language is used in the people, things and things with the same name as NER?	MF_Tysnes	shipnamesake	language
where is the birthplace of the father of NER?	Dongfu_see_Ciqia	father	fatherofwife
what is the rank of the people, things and things with the same name as NER?	German_destroyer_molders	shipnamesake	rank
who is before the commander of NER	Battle_of_Legnano	commander	before
which dynasty does the father of NER belong to?	Princess_of_Zhongshan_(Northern_Qi)	father	dynasty
which timezone does the person and things that shares the same name with NER belong to?	HMCS_Wetaskiwin	shipnamesake	timezone
where does the parent of NER belong to?	Frank_Russell,_2nd_Earl_Russell	parents	order
where is the alma mater of the people, things and things with the same name as NER?	Nausitz	shipnamesake	almamater
what is the occupation of the one that is after election of NER?	United_States_Senate_election_in_North_Carolina,_1998	afterelection	occupation
who takes the place of the father of NER?	Princess_Liyang	father	spouse
what is the start of the country that is spoken NER?	Zengvarcony	states	establishedevent
what is the genre of the name included in the NER?	List_of_awards_and_nominations_received_by_Billy_Ray_Cyrus	name	genre
which title does the administrative area responsible for NER belong to?	Governor_of_Genoa	body	titleleader
what is children of the one that is after election of NER	Democratic_Republican_Party_(South_Korea)	afterelection	children
whose ancestor is the father of NER??	Gyeongjong_Goryeo	father	issue
which title does the bay that NER is famous for belong to?	Steven_Vogt	knownfor	title
which award is the one who is alongside NER given?	Takashi_Sakai	alongside	clubs
what is the event of the event happened in NER	Kingdom_of_Galicia_and_Lodomeria	event	event
what is the name of the person who influenced the origin of NER's name?	Sherrington_(crater)	eponym	influences
which branch does the person and things that shares the same name with NER belong to?	French_cruiser_Foch	shipnamesake	branch
what is the status of the cause of NER?	First_Battle_of_Newtonia	result	status
which language is used in the location province of NER	Ofir_Davidzada	state/province	language
who built the people, things and things with the same name as NER?	Osterley_(1780_EIC_ship)	shipnamesake	architect
who is the monarch of the person and things that shares the same name with NER ontario?	HMCS_Carleton	shipnamesake	monarch
which affiliation does the alma mater of NER belong to?	Evangelical_Witnesses_Association	almamater	affiliations
what is the person and things that shares the same name with NER awarded?	German_cruiser_Blucher	shipnamesake	awards
which title does the commander of NER belong to?	Northeast_Autumn_1947_Campaign	commander	title
who created the bay that NER is famous for?	Claude_Garamont	knownfor	creator
who leads the event happened in NER?	upper_germania	event	leader
what is the deathpalce of the person whose name is used to name NER?	Lippershey_(crater)	eponym	placeofdeath
what is the series of things related to NER	sony_xperia_z3+	related	series
what is the government type of NER related events?	Karelian_Autonomous_Soviet_Socialist_Republic	event	governmenttype
where is the alma mater of NER located?	Mark_Van_Ameyde	almamater
which museum includes the caption of the country that is spoken NER	Baekje	states	caption
who is the parent of the parent of NER?	Franklin_Delano_Roosevelt_III	parents	parents
what it the product of the team that won NER	Thomas_Pages	team	products
who has an important influence on the client of NER?	Crane_Garden	client	influences
which country does the person and things that shares the same name with NER belong to?	Nausitz	shipnamesake	president
which region does the bay that NER is famous for belong to?	Meyer_Amschel_Rothschild	knownfor	region
what is the origin of NER known for's name?	Boltzmann_equation	eponym	field
what is the person and things that shares the same name with NER	Mikhail_Vasilievich_Lomonosov	shipnamesake	workplaces
which mountain range does things related to NER belong to?	Xbox_(brand)	related	parent
which battle is the people, things and things with the same name as NER involved?	Russian_destroyer_Marshal_Shaposhnikov	shipnamesake	battles
where is the birthplace of the one that is influenced by NER?	Bernard_Lewis	influenced	birthplace
what is the job of the singer who participated in NER?	Aim_High_(TV_series)	extra	profession
which religion does the people, things and things with the same name as NER belong to?	James_Madison	shipnamesake	religion
which language is commonly used in the person and things that shares the same name with NER?	Mohawk_Dutch	shipnamesake	languages
what started the person and things that shares the same name with NER?	Laika_(1939)	shipnamesake	eventstart
who is the predecessor of the client of NER?	Royal_Spring,_Warsaw	client	predecessor
what is the nickname of the alma mater of NER?	Paul_Bailey_(politician)	almamater	city
who is the source of the origin of NER's name?	Penticton_(crater)	eponym	source
who is the consort of the people, things and things with the same name as NER?	Asteroid_1816	shipnamesake	consort
where does the event of NER take place?	Chinese_Empire	event	place
which type does the country that is spoken NER belong to?	Jincheng_dialect	states	subdivisiontype
which event establishes the country of birth of NER?	Igor_Cvitanovic	countryofbirth	establishedevent
which school does the artist who sings for NER belong to?	Oriental_Juliet	extra	birthplace
who created the theme of NER?	Hong_Kong_Sheng_Kung_Hui_Diocese_of_Hong_Kong_Island	theme	artist
which title does the cause of NER belong to?	Battle_of_Bedriacum	result	subdivisiontype
who is the female parent of the person and things that shares the same name with NER?	Harald_V	shipnamesake	mother
what is the format of the notable work of NER	Aleks_Krotoski	notableworks	format
what is the legislature of the country of birth of NER?	Igor_Cvitanovic	countryofbirth	legislature
which house does the event of NER belong to?	Gurjara-Pratihara	event	house
what is the work place of the people who influence NER?	Alexander_Rich	influences	workplaces
who is the predecessor of the leader of NER?	United_Kingdom_general_election,_1886_(Ireland)	leader	title
what is the instrument that the name included in the NER plays?	List_of_awards_and_nominations_received_by_Jessica_Simpson	name	instrument
who is the director of the theme of NER?	Hong_Kong_Sheng_Kung_Hui_Diocese_of_Hong_Kong_Island	theme	director
which label does NER belong to related events?	UEFA_Women's_Euro_2013_Final	event	label
what is the cause of the event involved in NER?	List_of_Czech_monarchs	event	result
when is the author of NER born?	Can_I_Borrow_a_Dollar%3F	chronology	format
which league does the team that won NER belong to?	1923–24_Atromitos_FC_season	team	league
who is the spouse of the parent of NER?	Buch	parents	subdivisiontype
which team takes part in the author of NER dj quik, lord tariq and peter gunz?	The_Way_It's_Goin'_Down	chronology	team
where did the combatant of NER die?	Battle_of_Que_Mountain	combatant	deathplace
who directed the team that won NER?	Red_Bull_RB12	team	director
which title does the client of NER own?	Royal_Spring,_Warsaw	client	title
which language does the singer who performed for NER use?	genius_babysitter	extra	occupation
who makes the law of the cause of NER	First_Battle_of_Newtonia	result	legislature
who is before the father of NER?	princess_of_qingdu	father	subdivisiontype
who is the successor of the people, things and things with the same name as NER?	Warren_Hastings_(1802_EIC_ship)	shipnamesake	successor
who honored the children of NER?	Anwar	children	type
who is the successor of the one who is alongside NER	Decius	alongside	title
what is the occupation of the author of NER?	Lovers_Walk	chronology	occupation
where does the one that is after election of NER belong to?	United_States_presidential_election_in_Minnesota,_1968	afterelection	district
what is the title of the children of NER?	Women's_Day	children	title
who is the predecessor of the people, things and things with the same name as NER?	Charles_Evans_Hughes	shipnamesake	after
who married the eponym of NER?	Cori_(lunar_crater)	eponym	spouse
what is the subdivision name of the people, things and things with the same name as NER?	HMCS_Kamloops	shipnamesake	subdivisionname
who is the chairman of the sponsor of NER?	SummerSlam_(1994)	sponsor	chairman
where is the combatant of NER born?	Battle_of_Que_Mountain	combatant	deathplace
where did the origin of NER study's name?	Nagaoka_(crater)	eponym	almamater
which affiliation does the alma mater of NER belong to?	He_Chengtian_(architect)	almamater	affiliation
who is the spouse of the one that is after election of NER?	German_presidential_election,_1994	afterelection	spouse
what is the author of NER?	Unbreakable_(Janet_Jackson_album)	chronology	profession
what is the branch that the parent of NER belongs to?	Didit_Hediprasetyo	parents	branch
which timezone does the team that won NER belong to?	Herrera	team	timezone
which dynasty is the leader of NER born?	Dervish_state	leader	placeofbirth
what is the timezong of the people, things and things with the same name as NER?	Type_05_micro-sound_submachine_gun	shipnamesake	timezonedst
what is the location country of the client of NER?	elevator	client
who is issued by NER related events?	Gurjara-Pratihara	event	issue
what is the warrior of the person and things that shares the same name with NER?	SAS_Isandlwana_(F146)	shipnamesake	partof
which is the capital of the location province of NER?	Grupo_Salinas	state/province	capital
who is the successor of the successor of NER?	Ferdinand_Philip_(Duke_of_Orleans)	issue	successor
which house does the person and things that shares the same name with NER belong to?	black_west_province	shipnamesake	house
what is the electoral district of the sponsor of NER?	Stafford_(UK_parliamentary_constituency)	sponsor	constituencywestminster
where does the people, things and things with the same name as NER take place?	Rivoli	shipnamesake	partof
which party does the people, things and things with the same name as NER belong to?	Asteroid_1844	shipnamesake	party
which place is called as the subdivision of the city in the south of NER?	Bally-Lobrega	s	arrondissement	subdivisiontype
which national team does NER's coach belong to?	Seattle_University	s
who is influenced by the name included in the NER?	Empon_Volcano	name	influenced
which title does the nickname of NER belong to?	Si_Xi	nickname	title
which team won the coach of NER	Brooklyn_Nets	coach	team
who did a job before the person and things that shares the same name with NER?	Asteroid_1895	shipnamesake	after
which religion does the leader of NER believe?	Federal_Republic_of_Indonesia	leader	religion
what is the address of the person whose name is used to name NER	Cori_(lunar_crater)	eponym	residence
which country does the person whose name is used to name NER belong to?	Mendes_Pinto_(crater)	eponym	nationality
who is the founder of the person and things that shares the same name with NER?	Soviet_Army_Central_Cluster	shipnamesake	founder
where did the one that is after election of NER study?	United_States_Senate_election_in_North_Carolina,_1998	afterelection	almamater
which country does the theme of NER belong to?	Harry_Potter_and_the_Goblet_of_Fire	theme	country
what is the largest city of the person and things that shares the same name with NER	Brazilian_monitor_Alagoas	shipnamesake	largestcity
what kind of company is the sponsor of NER?	Vodacom_Cup	sponsor	companytype
who is issued by the people, things and things with the same name as NER?	Queen_Mary_(UK)	shipnamesake	issue
which province does the alma mater of NER belong to?	Amy_Tan	almamater	provinceprovince
what does the status of the people, things and things with the same name as NER belong to?	Plymouth_(Montserrat)	shipnamesake	status
what is the map caption of the people, things and things with the same name as NER?	French_ship_Polyphemus_(1815)	shipnamesake	subdivisiontype
what is the type of NER's related products?	Kinder_Surprise_Egg	related	type
which country does the alma mater of NER belong to?	Shang_Jin_Fu_Wang	almamater	country
what is the alma mater of the one that is influenced by NER?	Alain_Badiou	influenced	almamater
which label does the author of NER work for?	The_Milt_Jackson_Big_4	chronology	label
what is the leader title of the location province of NER	Sun_Mingyang	state/province	leadertitle
what is the region of the person and things that shares the same name with NER?	Asteroid_286	shipnamesake	city
what is the office of the one that is after election of NER?	Northern_Cyprus_presidential_election,_2015	afterelection	office
which currency is used in the person and things that shares the same name with NER	Rhodesian_and_Nyasaland_pound	shipnamesake	currency
who makes the law of the location country of NER?	Bled_Castle	locationcountry	legislature
what is the religion of the man who influenced NER?	Giuseppe_Garibaldi	influences	religion
which country does the one that is after election of NER belong to?	United_States_Senate_election_in_North_Carolina,_1990	afterelection	president
who founded the controller of NER?	Brownsea_Castle	controlledby	founder
who is the director of the person and things that shares the same name with NER?	Dry_Stantine_Ankiel	shipnamesake	starring
which type of government does the person and things that shares the same name with NER belong to?	HMCS_Sherbrooke	shipnamesake	settlementtype
which one is presented before the person and things that shares the same name with NER	Dry_Stantine_Ankiel	shipnamesake	starring
who gives the honorific suffix of the parent of NER	Frank_Russell,_2nd_Earl_Russell	parents	honorificsuffix
what is the person whose name is used to name NER?	Cavendish_Crater	eponym	field
what is the title of the leader of NER	spanish_national_railway	leader	title
who did a job before the author of NER?	The_Way_It's_Goin'_Down	chronology	after
where is the birthplace of the leader of NER?	ancient_athens	leader	birthplace
what is originated from the people, things and things with the same name as NER	Apollo_11	shipnamesake	children
who is the spouse of the people, things and things with the same name as NER?	French_ship_Alexandre_(1857)	shipnamesake	succession
who takes the place of the commander of NER	Battle_of_Long_Point	commander	after
what is the constituency of the person and things that shares the same name with NER?	USNS_Harvey_Milk_(T-AO-206)	shipnamesake	constituency
which religion does the administrative area responsible for NER belong to?	Governor_of_Genoa	body	religion
who is before the nickname of NER?	Si_Xi	nickname	before
who does the people, things and things with the same name as NER influence?	Descartes	shipnamesake	influences
what is the era of the cause of NER?	First_Battle_of_Newtonia	result	era
what is the genre of the theme of NER	Harry_Potter_and_the_Goblet_of_Fire	theme	genre
who is the predecessor of the car that NER is related to?	HTC_One_X9	related	predecessor
who is the predecessor of the one that is after election of NER?	Italian_general_election,_1874	afterelection	after
who is the predecessor of the client of NER italy?	Royal_Palace_of_Ficuzza	client	predecessor
who is the predecessor of the leader of NER/ who is the father of the leader of NER	spanish_national_railway	leader	before
what is spoken by the leader of NER?	Dervish_state	leader	language
what is the club that NER's head coach belongs to?	Seattle_University	s
what is the style of the father of NER	Wong_Fei_Hung	father	title
what is the title leader of the cause of NER?	First_Battle_of_Newtonia	result	titleleader
which type of subdivision does the people, things and things with the same name as NER belong to?	Scarborough	shipnamesake	subdivisiontype
which office does the leader of NER belong to?	Miguel_Primo_de_Rivera_and_Saenz_de_Heredia	leader	office
who is the next the father of NER?	Heshuo_Hehui_Princess	father	succession
who commanded the name included in the NER?	Germanic	name
who is the male parent of the client of NER?	Royal_Spring,_Warsaw	client	mother
who is the successor of the father of NER?	princess_of_qingdu	father	subdivisiontype
who is the successor of the parent of NER	Franklin_Delano_Roosevelt_III	parents	after
who is the successor of the leader of NER?	Duchy_of_Anhalt	leader	issue
who is the creator of the notable work of NER?	Sarah_Michelle_Jenner	notableworks	creator
where is the constituency of the one that is after election of NER from?	1995_ROC_Legislative_Election	afterelection	constituency
who takes the place of the cause of NER	Battle_of_Tanshebrai	result	successor
who is the deputy of the combatant of NER?	grief_night	combatant	deputy
who takes the place of the war that happened in the era of NER?	United_Netherlands_Sovereign_Duchy	era	after
which country does the one that is after election of NER belong to?	Colombian_presidential_election,_1986	afterelection	country
what is the common language of the area of NER related events?	Kingdom_of_Galicia_and_Lodomeria	event	commonlanguages
what is the leader name of the person and things that shares the same name with NER?	Plymouth_(Montserrat)	shipnamesake	leadername
what is the nationality of the one that is after election of NER?	Civic_Democratic_Party_leadership_election,_1997	afterelection	cityofbirth
where is the people, things and things with the same name as NER located?	French_battleship_Carnot	shipnamesake	country
which event happened in the person and things that shares the same name with NER?	British_Malaya	shipnamesake	event
who is the mother of the client of NER?	Royal_Palace_of_Ficuzza	client	mother
what is the type of the archipelago that NER belongs to?	Milos	archipelago	type
which battle does the controller of NER take part in?	Transat_AT	controlledby	battles
which label does the country that is spoken NER have?	Zengvarcony	states	label
what is the event of the cause of NER?	First_Battle_of_Newtonia	result	event
what is the allegiance of the person and things that shares the same name with NER to?	Jackson_Democrats	shipnamesake	allegiance
which dynasty does the successor of NER live in?	Belengalia_(Castile)	issue	house
who is the successor of the cause of NER?	Battle_of_Bedriacum	result	postalcodetype
what is the type of the bay that NER is famous for?	John_Pemberton	knownfor	type
who is the predecessor of the one who is alongside NER?	Zhong_Guobin	alongside	predecessor
who is the predecessor of the children of NER	Joseph_Chamberlain	children	predecessor
what is the region of the chief town of NER?	Liudu_Town	chieftown	canton
which timezone does the city in the south of NER ponent, lleida province, spain, belong to?	Montgai	s	w
what is the rank of the one that is after election of NER?	Guatemalan_general_election,_2011	afterelection	rank
who did a job before NER-related products+?	Sony_Xperia_Z3	related	before
where is the location province of NER seated?	Luo_Lemin	state/province	seattype
where is the capital of the person and things that shares the same name with NER located?	St._Helena	shipnamesake	issue
what is the allegiance of the one who is alongside NER to?	Takashi_Sakai	alongside	alongside
where did the leader of NER die?	The_Great_Deed_of_National_Salvation	leader	deathplace
which bay lies in the southwest of the country of birth of NER?	Igor_Cvitanovic	countryofbirth	southwest
what is the title of the car that NER is related to?	Invincible_intelligence_agent	related	previousshow
which branch does the one that is after election of NER belong to?	Thai_general_election,_1996	afterelection	branch
what is the title of the war that happened in the era of NER?	United_Netherlands_Sovereign_Duchy	era	title
who owns the sponsor of NER?	Newton_Football_Club	sponsor	owner
what includes the event of NER	Tanukhids	event	partof
which type does the location province of NER belong to?	Temple_Cave_Palace	state/province	type
who is the producer of the person and things that shares the same name with NER?	Dry_Stantine_Ankiel	shipnamesake	studio
which battle is the one that is after election of NER involved?	South_Korean_presidential_election,_1980	afterelection	battles
which type of post code does the people, things and things with the same name as NER belong to?	USS_Winnemucca_(PC-1145)	shipnamesake	postalcodetype
what is the office of the one who is alongside NER?	Yong	alongside	office
where did the people, things and things with the same name as NER die?	French_cruiser_Foch	shipnamesake	deathplace
who founded the sponsor of NER	Daughter_of_Venice	sponsor	founder
what is the origin of the name included in the NER?	Selangor_State_Honors_and_Awards_System	name	origin
when is the one that is after election of NER born?	United_Democratic_Party_(Belize)	afterelection	placeofbirth
who is earlier than the author of NER?	The_Way_It's_Goin'_Down	chronology	before
who is the mother of the leader of NER?	Median_Kingdom	leader	religion
which place is called as the subdivision of the chief town of NER	Four-One_Mountain_Cannon	chieftown	subdivisionname
who makes the law of the location province of NER?	Pyrkakay_mine	state/province	legislature
what is the title leader of NER related events?	Kingdom_of_Galicia_and_Lodomeria	event	titleleader
what does the leader of NER succeed?	Median_Kingdom	leader	successor
who gives the honorific suffix of the commander of NER?	Battle_of_Long_Point	commander	honorificsuffix
what does the chief town of NER belong to?	Montreuil	chieftown	arrondissement
who is the predecessor of the successor of NER?	Belengalia_(Castile)	issue	predecessor
who takes the place of the successor of NER?	Ujik	issue	after
which timezone does the location province of NER belong to?	Selkirk_mine	state/province	timezone
where is the city in the south of NER seated?	Garrigues_(comarca)	s	subdivisionname
who is the most important people of the sponsor of NER?	Telstra_Phonewords_Stakes	sponsor	keypeople
which timezone does the northwest of NER belong to?	Tornabous	nw	timezone1dst
who is the leader of the parliament of seats held by NER?	indonesian_militant_democratic_party	seats1title	leader
who takes the place of the commander of NER?	Battle_of_Legnano	commander	successor
what is the warrior of the name included in the NER?	Germanic	name
who manufactured things related to NER?	Nokia_E5-00	related	manufacturer
what is the title of the person and things that shares the same name with NER	Greek_Philosophy	shipnamesake	title
what is the allegiance of the leader of NER to?	ancient_athens	leader	allegiance
what is the type of the alma mater of NER?	Gard_Gordon	almamater	type
who is the incumbent of the leader of NER?	Community_of_Saint_Anselm	leader	incumbent
what is the succession of the successor of NER?	Ferdinand_Philip_(Duke_of_Orleans)	issue	succession
what is the singer who participated in NER	Ollusion	extra	occupation
what does the country admin division of the archipelago that NER belongs to belong to?	new_britain_island	archipelago	countryadmindivisions
what is the alma mater of the man who influenced NER?	Giuseppe_Garibaldi	influences	almamater
who is the premier of the commander of NER?	Northeast_Autumn_1947_Campaign	commander	premier
who is the coach of the team that won NER	Orlando_Magic	coach	college
which genre does the singer of NER belong to?	I'm_so_sorry	extra	starring
what does the person and things that shares the same name with NER end up in?	British_Malaya	shipnamesake	eventend
who is the prime minister of the leader of NER	House_of_Assembly_of_Saint_Vincent_and_the_Grenadines	leader	primeminister
what is the profession of the leader of NER?	French_regional_elections,_2015	leader	profession
where is the stadium of the important event of NER held?	Queens_Park_Rovers_2010-2011_season	s	team
which instrument does the author of NER play?	Entertainment_(Album)	chronology	instrument
what is the nationality of the people, things and things with the same name as NER?	Type_13_ship_attack_aircraft	shipnamesake	nationality
who is the predecessor of the one that is after election of NER?	French_legislative_election,_1893	afterelection	predecessor
which dynasty does the cause of NER live in?	Battle_of_Tanshebrai	result	house
what lies in the northwest of the county that NER belongs to?	budgers_hill	shirecounty	northwest
who makes the law of the person and things that shares the same name with NER?	Plymouth_(Montserrat)	shipnamesake	legislature
which party does the NER-held parliament belong to?	indonesian_militant_democratic_party	seats1title	party
what is the person and things that shares the same name with NER known for?	Asrock_anti-submarine_missile	shipnamesake	field
which office does the person and things that shares the same name with NER belong to?	Oscar_von_Hindenburg	shipnamesake	office
what is the combatant of the event of NER?	Feţele_Albe_Dacian_fortress	event	dynasty
where did the leader of NER study?	United_Kingdom_general_election,_1886_(Ireland)	leader	title
how to address the commander of NER?	Battle_of_Varese	commander	honorificprefix
what is the southwest of the location province of NER	Sakhalin_Region	state/province
which country does the country that is affected by NER belong to?	1857_Basilicata_earthquake	countriesaffected	country
who is the predecessor of the leader of NER	Michael_Ellis_(British_politician)	leader	predecessor
who is the successor of the client of NER?	Royal_Palace_of_Ficuzza	client	successor
who is the descendant of the commander of NER?	The_Battle_of_Dingtao_(Eastern_Han_Dynasty)	commander	issue
which genre does the person and things that shares the same name with NER belong to?	Henrik_Ibsen	shipnamesake	genre
who takes the place of the car that NER is related to?	Sony_Xperia_T	related	successor
what it the product of the sponsor of NER	Black_Opal_Stakes	sponsor	products
where is the birthplace of the one that is after election of NER	Colombian_presidential_election,_1998	afterelection	birthplace
which place is called as the subdivision of the northwest of NER?	Albucies	nw	subdivisiontype
which city does the people, things and things with the same name as NER belong to?	Asteroid_286	shipnamesake	city
who starred in the works that make NER known?	Khalid_Siddiqui	notableworks	extra
which dynasty is the person whose name is used to name NER born?	Haldane_(lunar_crater)	eponym	education
what is the title of the father of NER?	Princess_Yongan_(Tang_Xianzong)	father
who is the predecessor of the children of NER?	Joseph_Chamberlain	children	predecessor
which program is before NER's famous works?	Hiro_Fujiwara	notableworks	genre
what is connected with the person and things that shares the same name with NER?	USS_Hopi_(AT-71)	shipnamesake	related
what is the name of the one that is after election of NER?	United_Malaysia_National_Organization_leadership_election,_2009	afterelection	primeminister
where did the commander of NER die?	Siege_of_Khartoum	commander	almamater
which award is the person whose name is used to name NER given?	Meitner_(Venusian_crater)	eponym	awards
what is the origin of the author of NER?	Chaos_Paradise_(album)	chronology
where does the leader of NER belong to?	United_Kingdom_general_election,_1886_(Ireland)	leader	title
what is the status of the combatant of NER?	Battle_of_Chiayi	combatant	status
what is the type of the sponsor of NER?	Waterstones_11	sponsor	type
who is the father of the leader of NER?	Yue_Hua	leader
who married the author of NER	Someone_Put_Your_Hand_Out_(Michael_Jackson_song)	chronology	spouse
what is the postal code type of the country that is spoken NER?	Jincheng_dialect	states	postalcodetype
where did the one that is after election of NER die?	1955_Vietnam_referendum	afterelection	deathplace
which dynasty is the person and things that shares the same name with NER born?	USS_Schley_(DD-103)	shipnamesake	placeofbirth
what is the source of information of the combatant of NER?	Battle_of_Bangorach	combatant	source
what is the southwest of the location country of NER?	Bled_Castle	locationcountry	southwest
which industry is the team that won NER from?	Ginger_Rogers	team	industry
which national team does the name included in the NER belong to?	Brunei_under-21_football_team	name	nationalteam
which sport does NER's coach play?	2014–15_SC_Freiburg_season	s	position
what is the province of the client of NER?	Cikai_Town	client	provinceprovince
what is the common language of the country of birth of NER	Gabriel_Sacuiani	countryofbirth	commonlanguages
who is the owner of the team that won NER?	Red_Bull_RB12	team	owner
what is in the charge of the person and things that shares the same name with NER?	Carl_Levin	shipnamesake	order
what is the name included in the NER?	List_of_awards_and_nominations_received_by_Billy_Ray_Cyrus	name	occupation
what is the profession of the person and things that shares the same name with NER	Carl_Levin	shipnamesake	profession
which war is included in the era of the name included in the NER?	Empon_Volcano	name	era
which genre does the sponsor of NER belong to?	breaking_Bad	sponsor	genre
where does the one that is after election of NER live?	Peruvian_general_election,_1985	afterelection
what is the subdivision rank of the person and things that shares the same name with NER?	Asteroid_1788	shipnamesake	subdivisionranks
who is the leader of the country that is spoken NER	Baekje	states	leader
where is the eponym of NER born?	Hevelius_(crater)	eponym	birthplace
who is the one that is after election of NER?	Romanian_National_Liberal_Party	afterelection	predecessor
who is the last of the commander of NER?	The_Battle_of_Dingtao_(Eastern_Han_Dynasty)	commander	regent
what is the canton of the northwest of NER?	Amiens	nw
which language is commonly used in the people, things and things with the same name as NER	British_Malaya	shipnamesake	commonlanguages
who gives the honorific suffix of the people, things and things with the same name as NER?	flashlight	shipnamesake	title
where does the bay that NER is famous for come from?	Meyer_Amschel_Rothschild	knownfor	origin
what kind of company is NER-related products?	WingNut_Films	related	companytype
where is the people, things and things with the same name as NER?	USS_Tutuila_(ARG-4)	shipnamesake	location
who is the consort of the name included in the NER?	Chinese_popular	name	consort
what is the type of the origin of NER's name?	Bolsena_Lacus	eponym	type
who is the founder of NER's record company?	Destiny_(Game)	label	founders
what is the name included in the NER	List_of_awards_and_nominations_received_by_Craig_David	name	profession
which title does the event happened in NER belong to?	Kingdom_of_Galicia_and_Lodomeria	event	titleleader
where is the archipelago that NER belongs to located?	fairy_shoal	archipelago	location
which event establishes the location country of NER?	Bled_Castle	locationcountry	establishedevent
who is the descendant of the cause of NER?	Battle_of_Tanshebrai	result	issue
who married the father of NER?	Goryeo_Kwangjong	father	spouse
which country does the person and things that shares the same name with NER belong to?	French_battleship_Danton	shipnamesake	nationality
what is the ethnicity of the people, things and things with the same name as NER?	Bu_Bailiu	shipnamesake
which religion does the father of NER belong to?	Elihia	father	religion
which religion does the country of birth of NER belong to?	Rhones_Garvay	countryofbirth	religion
who is the director of NER's famous works?	Khalid_Siddiqui	notableworks	producer
which industry is the sponsor of NER from?	Telstra_Phonewords_Stakes	sponsor	industry
who is the predecessor of the client of NER?/ who is the father of the client of NER?	Royal_Palace_of_Ficuzza	client	before
what is the typical subdivision of the northwest of NER spain?	Gurb	nw	subdivisiontype
what is the province of the people, things and things with the same name as NER?	Italian_cruiser_Vittorio_Veneto	shipnamesake	provinceprovince
what is birth place of the successor of NER?	Ramiro_I_(Asturias)	issue	burialplace
where does the leader of NER get the honorific suffix?	London_local_elections,_2018	leader	title
who is the next the cause of NER?	Battle_of_Tanshebrai	result	succession
who is earlier than the person and things that shares the same name with NER?	Cornwallis_Island_(Canada)	shipnamesake	before
which country does the alma mater of NER belong to?	Edward_Gallek	almamater	country
which company lies in the east of the largest city of NER?	Mato_Grosso	largestcity	east
what does the people, things and things with the same name as NER succeed?	Leopoldus_Primus	shipnamesake	succession
who is the extra of the car that NER is related to?	happy_family	related	opentheme
what is the burial place of the client of NER?	Royal_Spring,_Warsaw	client	placeofburial
which religion does the combatant of NER belong to?	grief_night	combatant	religion
what is the nationality of the leader of NER?	National_Convention	leader	nationality
who is the spouse of the one who is alongside NER?	Dong_Biwu	alongside	spouse
what is the deathpalce of the person and things that shares the same name with NER?	President_Ayes	shipnamesake	placeofdeath
who is the father of the people, things and things with the same name as NER?	P6M_Sea_Master_Jet_Airship	shipnamesake	father
who does the sponsor of NER work for?	Medal_of_Merit_(USA)	sponsor	allegiance
which mountain range does the sponsor of NER belong to?	2011_Penrith_Panthers_season	sponsor	parent
who is the parent of the children of NER?	Anwar	children	type
where did the eponym of NER die?	Eijkman_(crater)	eponym	deathplace
which city does the alma mater of NER belong to?	Cleo_Baldon	almamater	city
who is the commander of the controller of NER?	Transat_AT	controlledby	commander
where is the event of NER located?	Kingdom_of_Galicia_and_Lodomeria	event	titleleader
who is the director of the sponsor of NER?	Night_of_Champions_(2012)	sponsor	format
where is the capital of the location of NER located related events?	First_Hungarian_Republic	event	capital
who starred in the singer who performed for NER?	5_(album)	extra	studio
which place is called as the subdivision of the southeast of the south of NER?	New_Harmony_(Utah)	south	southeast	subdivisionname
what is the name of the chairman of the incumbent of the title of NER?	Candy_Sipanton	title	incumbent	chairman
what is in the charge of the successor of the candidate of NER?	Constitution_election_results_in_the_United_Kingdom_general_election,_1923	candidate	after
what is the start of the location of the national team that NER belongs to?	Rad_Bogdanovic	nationalteam	location	timezone1dst
what is the religion of the location of the national team that NER belongs to?	Peng_Zijian	nationalteam	location	religion
what is the subdivision type of the north of the northeast of NER utah, united states?	Antimony_(Utah)	northeast	north	subdivisiontype
what is the timezong of the east of the south of NER?	Wales_(Utah)	south	east	timezonedst
what is the timezong of the east of the south of NER utah, united states?	Wales_(Utah)	south	east	timezonedst
which timezone does the north of the west of NER belong to?	Andel_Poststrasse	west	north	timezonedst
where is the alma mater of the successor of the candidate of NER?	French_regional_elections,_2010	candidate	after	almamater
what is the deathpalce of the successor of the descendant of NER?	Mary_of_Hungary,_Queen_of_Naples	issue	after	succession
what is the subdivision name of the northeast of the southeast of NER?	Fillmore_(Utah)	southeast	northeast	subdivisionname
which country does the predecessor of the premier of NER former president of the republic of china, belong to?	Ma_Ying-jeou	premier	before	president
who is the female parent of the successor of the descendant of NER?	bohemia	issue	after	mother
which type of subdivision does the southeast of the southwest of NER utah, united states, belong to?	Camers_(Utah)	southwest	southeast	subdivisiontype
who did a job before the predecessor of the candidate of NER?	Neath_(UK_Parliament_constituency)	candidate	predecessor	predecessor
what is the timezong of the west of the location of NER?	He_Junyao	location	w	timezone
who do the job after the successor of the children of NER?	Sobekmsav_II	children	successor	successor
which dynasty does the legislature of the state party of NER belong to?	Prehistoric_pile_dwellings_around_Lake_Zurich	stateparty	legislature	house
who did a job before the first the title of NER?	Duncan_Edwards	title	first	after
town in Dudgett County, Utah, United States, the location in the south of NER, the location in the southwest, which division belongs to	Manila_(Utah)	south	southeast	subdivisionname
what type of person or thing with the same name as NER	Kilauea_Volcano	shipnamesake	type
who is affected by the person, thing, or thing with the same name as NER?	Descartes	shipnamesake	influenced
what is the zoning of the location in the south of the city where NER is located?	National_Register_of_Historic_Places_listings_in_Montana	city	south	subdivisiontype
what is the area of the location in the northwest of the city where NER is located?	Administrative_divisions_of_South_Dakota	city	northwest	subdivisionname
who is the successor of NER's election winner?	Italian_general_election,_1992	afterelection	successor
what is the zoning of the location in the north of NER?	France_at_the_2015_World_Speed_Skating_Championships	location	north	subdivisiontype
who is the last of the title of NER?	Jude	title	last	after
where was the first person with the title of NER born?	Shahabuddin_Ahmed	title	inaugural
A town in Pinnacle County, Utah, USA, what is the area of NER, the location in the southwest, and the location in the north?	Francis_(Utah)	southwest	north	subdivisionname
what is the country region of the location in the northern part of the province where NER is located?	List_of_Cultural_Properties_of_the_Philippines_in_Cagayan_Valley	provinceprovince	north	region
NER, the 1991 edition of the FIFA Women's World Cup, what is the title of the venue leader in the northeast of its host	1991_FIFA_Women's_World_Cup	stadium	northeast	leadertitle
what event is the person or thing with the same name as NER	French_ship_Wagram_(1854)	shipnamesake	partof
what is the occupation of the singer who participated in NER?	That_winter,_the_wind_blows	extra	profession
what is the religion of the origin of the name NER?	Aryabhata_(crater)	eponym	region
where the person whose name is used to name NER was born	Fabry_(crater)	eponym	birthplace
who is the predecessor of the person, thing, and thing with the same name as the Hamburg escort NER?	Leopoldus_Primus	shipnamesake	predecessor
NER, Wikimedia listing article, what team is the captain of its club location	2009_FIFA_U-17_World_Cup_squads	club	name	clubs
what time zone does the location in the east of NER belong to?	Huntington_(Utah)	east	southwest	timezonedst
what is the division of the location in the southwest of NER's city?	List_of_closed_railway_stations_in_Ireland	countycounty	southwest	subdivisiontype
what is the title of NER's election winner	Brazilian_presidential_election,_1969	afterelection	title
what party does NER's namesake belong to?	Erastus_Mwencha	almamater
what area does NER's southern region belong to?	Platt_de_Comte	s	subdivisionname
where is the location of the location in the east, where the NER is held for a season of French football clubs	2009-10_Olympique_de_Marseille_season	stadium	tenants	city
and NER what is the area to which the person or thing with the same name belongs	SMS_Zenta	shipnamesake	subdivisionname
what state is NER's alma mater in?	Susannah_Grant	almamater	state
who led the legislature where NER died	Vasili_Yanchenko	deathplace	legislature	leader
what type of company is the owner of a NER club location?	2013_World_Baseball_Classic_-_Group_A	club	predecessor	successor
who is the current incumbent of the title of NER?	Wen_Jiabao	title	incumbent	office
French politician (1885-1956) who was the predecessor of the previous generation of NER	Yvonne_Delbos	before	predecessor	predecessor
where is the address of NER related events	Chinese_Empire	event	place
what is the name of the mother of the ruler of the descendants of NER?	Maria_Pia_(Two_Sicilies,_1849-1882)	issue	mother
what is the nickname of NER's alma mater?	Mark_Van_Ameyde	almamater
who leads the legislature where NER is used	Renault_FT	usedby	legislature
what products do NER's sponsors have	Telstra_Phonewords_Stakes	sponsor	products
NER's location what time zone does the city in the west belong to?	Maritimo_Athletic_Association	location	w	timezone
which city is the operator of NER's location?	Torquay_United_Football_Club	team
what is the origin of the name of NER?	HMCS_Vimy	shipnamesake	partof
The name of the location leader of the Eastern location of the NER location for a season of the football team is	2015_Beijing_Guoan_FC_season	location	east	leadername
NER, British politician (born 1967) who is its leader	Michael_Ellis_(British_politician)	leader	successor
A town in Millard County, Utah, United States what is the time zone of the location in the southeast of NER, the location in the northeast?	Meadow_(Utah)	southeast	north	timezone
what is the famous work of the person named NER?	Maclaurin_(crater)	eponym	knownfor
NER's election winner who's successor	United_States_Senate_election_in_Vermont,_1980	afterelection	successor
who is the successor of NER's election winner?	Democratic_Party_(HK)_leadership_election,_2002	afterelection
what time zone is used in the southern region of NER?	Malcots	s	w
which district does the city in the west of the birthplace of SS officer NER belong to?	Adolf_Urban	countryofbirth	titleleader
where are NER related events held?	UEFA_Euro_1980_Final	event	stadium
where is the birthplace of people, things and things with the same name as NER?	Libyan_President	shipnamesake	birthplace
who is the leader of the legislature where the French light tank NER of 1936 was used	Hotchkiss_H35	usedby	legislature
NER, the early dynastic confederation of ancient Egypt (c. 3150 AD) whose leader was the last	Confederate	leader	successor
NER, Wikimedia list article, what are the titles of the leaders of the locations south of the city where they are located	National_Register_of_Historic_Places_listings_in_Snohomish_County,_Washington	city	southwest	subdivisiontype
NER's election winner who's successor	German_presidential_election,_2009	afterelection	successor
what classification level does the person or thing with the same name as NER belong to?	clover	shipnamesake	subdivisionranks
what is the zoning of the area to the northwest of NER Catalonia, Spain	Albucies	nw	subdivisiontype
which film company does NER's related products (works) belong to?	Shark_(Korean_TV_Drama)	related	author
who are the people influenced by the people in NER?	Empon_Volcano	name	influenced
what dynasty does NER's name belong to?	Sofia_(Spanish_princess)	shipnamesake	house
NER, Vancouver Whitecaps football season, what is the zoning of the location west of its location	Manchester_City_2009-2010_season	location	west	subdivisiontype
what is the division of the administrative center of the father of NER, a mountain range in southeastern Poland	Pogorze_Bukowskie	parent	seat	subdivisiontype
what is the time zone of the location north of the international football match NER?	2015_International_Champions_Cup	stadium	north	timezonedst
who is NER's child with the same name	Apollo_11	shipnamesake	parents
Who's the previous election winner for Wall NER?	United_States_Senate_election_in_North_Carolina,_1990	afterelection	before
what party is the election winner for Wall NER?	South_African_general_election,_1977	afterelection	predecessor
where NER's election winner was born	Lithuanian_election_election,_2000	afterelection	placeofbirth
NER what is the name of the leader of its province	Hund	state/province	leadername
what is the title of the consort of the ruler of NER	Sultan_Badis	regent	issue
Wikimedia listing article NER location what is the title of the location leader in the west	Major_national_historical_and_cultural_sites_(Guangdong)	location	west	leadertitle
NER's location what time zone does the northern location belong to?	South_Carolina_Highway_151	location	north	timezonedst
In a French state (as of March 2015) which district is the main town of NER	Neuilly-Saint-Fron	chieftown	arrondissement
what time zone is the location in the southeast of the city where the Wikimedia list article NER is located	National_Register_of_Historic_Places_listings_in_Sanpete_County,_Utah	city	southeast	timezone
what is the predecessor of NER's election winner?	United_States_Senate_election_in_North_Carolina,_1990	afterelection	before
what is the zoning of the location in the southern part of the international football match NER?	2015_International_Champions_Cup	stadium	south	subdivisiontype
NER to which dynasty the legislature of its country belongs	Research_Institute_of_Organic_Agriculture	country	legislature	house
what is the religion of NER's clients?	house	client	religion
NER Catalonia, Spain, where is its northwest area	Gurb	nw	subdivisionname
what is the common language of people, things and things that have the same name as NER?	French_destroyer_Tonkinois	shipnamesake	country
who is the leader of NER's successor?	University_of_Greenland	leader	successor
what is the zoning of the location in the southeast of NER Utah, United States?	New_Harmony_(Utah)	south	southeast	subdivisiontype
who are the generals of the people in NER?	Germanic	name
who is the father of NER's name	Asteroid_657	shipnamesake	father
town in Box Elder County, Utah, United States, what is the area of NER, the location in the east, and the location in the south?	Howell_(Utah)	east	namedfor	ground
what time zone does the administrative center of the birthplace of the Malaysian hockey player NER belong to?	Kuhan_Shanmuganathan	birthplace	capital
which division does the location in the east of NER's city belong to?	National_Register_of_Historic_Places_listings_in_Box_Elder_County,_Utah	city	east	subdivisiontype
which state is the NER election winner in?	United_States_Senate_election_in_Vermont,_1980	afterelection	state
where is the location in the west of the city where NER is located?	Canyon_Mountains	city	west	subdivisionname
who is the predecessor of NER's election winner?	Romanian_National_Liberal_Party	afterelection	predecessor
who is the father of NER's client	house	client	father
who is the successor of the descendants of NER?	Leopold_IV_(Anhalt)	issue	succession
The field the person whose name is used to name the NER belongs to	Boltzmann_equation	eponym	field
what common language is used for flag events established by the location of NER?	Colombia_national_football_team_results_(1980–99)	location	establishedevent
NER's location what area is the east location in?	South_Carolina_Highway_151	location	east	subdivisionname
what instrument did the creator of NER use	Etta_James_(1973_album)	chronology	clubs
The royal family of the person, thing, and thing with the same name as NER	SS_Prinses_Astrid	shipnamesake	royalhouse
what is the famous work of the person named NER?	Harden_(crater)	eponym	knownfor
where did NER's election winner's voters come from?	Election_Committee_(Legislative_Council_constituency)_by-election,_2001	afterelection	district
which dynasty does the legislature where the NER take place belong to?	2007_Davis_Cup_World_Group	venue	legislature	house
A city in Cage County, Utah, United States, where is the location north of NER, which time zone is the location west of?	Logan_(Utah)	north	northwest	subdivisionname
what war did the person or thing with the same name as NER participate in?	HMS_Bramham_(L51)	shipnamesake	battles
what is the common language spoken in the administrative region to which NER belongs?	Governor_of_Genoa	body	commonlanguages	stadium
NER, the US college basketball season, which time zone is its home eastern location in	2015-16_Idaho_Vandals_men's_basketball_team	home	east	timezonedst
what is the industry of NER's sponsor?	SummerSlam_(1994)	sponsor	industry
what is the previous generation of the election winner of the convention NER that elects the U.S. senator?	United_States_Senate_election_in_Ohio,_1898	afterelection	before
NER's election winner whose last term was	Thai_general_election,_1996	afterelection	monarch
what is the name of the alma mater of NER's election winner	Labour_Party_(UK)	afterelection	almamater
in which city is NER's alma mater?	Albert_Camus	almamater	city
which district does the mayor of NER belong to?	Canton_of_Remiremont	chieftown
what titles do people, things and things with the same name as NER have?	French-Dutch_War	shipnamesake	title
A city in Garfield County, Utah, United States, where is the location in the north of NER, in which area is the location in the east?	Escalante_(Utah)	north	northwest	subdivisionname
NER, Earl of Limburg and Morse (1545-1589), to which division the birthplace of the previous generation belonged	Adolf_Butnant	before	genre
NER what is the constituency of the location in the east of its venue	English_Football_Isthmian_League	stadium	east	constituencywestminster
what is the constituency for the location west of a sports cricket match NER?	1993_Women's_Cricket_World_Cup	venue	west	constituencywestminster
which division does the southern part of the NER site belong to?	2012_Toulon_Tournament	stadium	south	subdivisiontype
who is the successor of NER's election winner?	israeli_labor_party	afterelection	successor
town in Uinta County, Utah, USA, what is the area of NER, the location east of the location, and the location in the northwest?	Ballard_(Utah)	east	north	subdivisionname
what dynasty belongs to a person or thing with the same name as NER?	Queen_Mary_(UK)	shipnamesake	house
who is the leader of the legislature for the position of NER	Bhutan_national_football_team_results	location	northwest	country
what is the zoning of the location in the southwest of NER's place of residence?	Pim_Futhun	deathplace	northwest	subdivisiontype
in which area is the same name of NER?	Amherst_College	shipnamesake	subdivisionname
who is the emperor of the person or thing related to the result of NER	Kalmar_United	result	leader
what team is the head coach of NER on?	2014–15_SC_Freiburg_season	s	clubs
A town in Wayne County, Utah, U.S.A. what is the area of NER?	Roja_(Utah)	northwest	north	subdivisionname
what is the predecessor of the previous generation of the descendants of NER	Adad_Nilari_III	issue	before	before
Wikimedia lists the location of the article NER what region does the location in the east belong to?	PI	location	east	subdivisionname
The 38th season in franchise history; what zone does the location in the northeast of the first Super Bowl winner NER belong to	2013_Seattle_Seahawks_season	stadium	southwest
what is the party affiliation of the legislature for the position of the football team for a season NER?	1980–81_Eintracht_Frankfurt_season	location	legislature	party
Whose predecessor was the place where the NER label was held?	German_Touring_Car_Masters	label	label	title
what is the tenant of the NER's venue named?	Kyoto_city	stadium	tenants	ground
which dynasty does the spouse of a descendant of NER belong to?	Dagbert_III	issue	spouse	house
which president does the NER's election winner serve?	israeli_labor_party	afterelection	president
where is the location in the southeast of NER's venue?	Twin_Cities_Conspiracy	country	capital	partstype
where is the district where the election winner of the Wall NER is located?	United_States_Senate_election_in_Wyoming,_2000	afterelection	district
what area is the southern city of NER in?	Malcots	s	w
who is the predecessor of NER's election winner?	French_legislative_election,_1914	afterelection	predecessor
what is the region of the NER location in the west and the location in the northeast?	plata_de_piaui	west	south	west
what is the zip code of the location in the northeast of NER?	List_of_former_Maryland_state_highways_(200–399)	location	west	postalcodetype
what is the rank of Wallner's election winner?	United_States_Senate_election_in_Wyoming,_2000	afterelection	rank
what is the zoning of the location in the northwest where NER died?	Willis_H_Downs	deathplace	northeast	subdivisiontype
what awards have people or things with the same name as NER won?	puller	shipnamesake	awards
what time zone is used in the city where the NER is held?	1996-97_UEFA_Cup	stadium	south	countryofbirth
what is the religion of NER's election winner?	Labour_Party_(UK)	afterelection	religion
who is the successor of NER's election winner?	Nigerian_general_election_2015	afterelection	successor
what area does the location in the north of NER belong to?	Hurricane_(Utah)	north	northwest	subdivisionname
which empire does NER's father belong to?	Elihia	father	dynasty
what is NER's famous work of the same name?	Spanish_cruiser_Don_Antonio_de_Ulloa	shipnamesake	knownfor
NER's election winner whose last term was	United_States_Senate_election_in_Ohio,_1898	afterelection	candidate
who is the king of NER's father (mother)	Frank_Russell,_2nd_Earl_Russell	parents	monarch
who is the successor of the successor of the descendants of NER?	Elizabeth_Charlotte_of_Orleans	issue	after	successor
what is the country of NER's election winner?	Spanish_Elections_2016	afterelection	country
what is the location of NER? what is the location in the north?	Leicester_City_2012-2013_season	location	northwest	subdivisionname
what is the time zone of the location in the NER Northwest and the location in the Southwest	Schofield_(Utah)	northwest	north	timezonedst
where is NER located in the North West	Jiangsu_Sainty_Football_Club	location	northwest	location
what is the zip code of the person, thing, thing with the same name as NER	HMCS_Levis_(K400)	shipnamesake	postalcodetype
what is the time zone of the location in the south of the NER and the location in the southwest	Snowbird,_Utah	south	southwest	timezonedst
in which area is the location south of NER Anoia, Catalonia, Spain	Spanish_monarch	s	subdivisionname
who is NER's predecessor of the same name	Fortitude_(1780_EIC_ship)	shipnamesake	successor
where do voters with the same name as NER come from?	USNS_Harvey_Milk_(T-AO-206)	shipnamesake	constituency
NER, submachine gun, which national system is used to mark events established where it is used	T-34_trainer	usedby	eventstart	after
what is the state of the election winner of NER, the convention that elects the U.S. senator?	United_States_Senate_election_in_Ohio,_1898	afterelection	state
Express trains between Brussels, Belgium and Switzerland (formerly Italy). what is the dynasty to which the legislature of NER's place belongs?	Vauban_(train)	locale	legislature
who is the leader of the flag event established by the location of NER	2008_in_American_soccer	location	establishedevent	leader
who is the general of the person or thing with the same name as NER?	Chilean_Senate	shipnamesake	commander
NER, Wikimedia listing article, what time zone is used for its location south of the city	National_Register_of_Historic_Places_listings_in_Larimer_County,_Colorado	city	south	timezone
what is the title of the location leader in the eastern part of the football game NER?	2015_AFC_Champions_League_Final	stadium	before
which party does Wallner's election winner belong to?	United_States_Senate_election_in_South_Dakota,_2014	afterelection	successor
who is the successor of the descendants of Queen NER of Sweden?	Josephine_of_Loktenburg	issue	successor
what is the flag event established by the location of the National Team of the Football Players Association NER?	Lin_Xiaocheng	nationalteam	location	establishedevent
which event determines the establishment of the area to which NER's nationality belongs	Luo_Ji	nationality	venue
NER's position is named after whose predecessor	State_highways_serving_Virginia_state_institutions	location	north	namedfor
what are the titles of the location leaders in the northwest of the NER's location?	2012_Chinese_FA_Cup	stadium	northwest	leadertitle
NER Catalonia, Spain, to which division its northwest location belongs	Province_of_Girona	nw	subdivisiontype
NER, diplomat and statesman of Imperial Japan (1887-1957), who was the predecessor of his successor's previous generation	Shigemitsu_Aoi	predecessor	before	successor
awhere is the location of Guangzhou Evergrande Taobao 2015NER in the northeast?	Guangzhou_Evergrande_Taobao_Football_Club	location	northwest	location
what is the title of the successor of NER's venue?	Uzbekistan_national_under-23_football_team_results	stadium	establishedevent	titleleader
what is the zoning of the location in the southeast of NER's home field?	2014-15_BYU_Cougars_women's_basketball_team	home	southeast	subdivisiontype
what is the name of NER, the leader of the location of the Northeast location of the football team for a season	Wu_Shanxin	location	west	leadername
who is the successor of the successor of the descendants of NER?	german_louis	issue	successor	successor
what is the previous generation of the founding emperor of NER's dynasty	Norodom_Monielle_Sihanouk	house	before	before
NER where is it located in the western part of the province	Sakhalin_Region	state/province
who is NER's successor's predecessor's next	young_louis	issue	issue	succession
what is the religion of the country (city) affected by NER	1857_Basilicata_earthquake	countriesaffected	religion
who is the successor of NER's election winner?	Tunisian_Constituent_Assembly_election,_2011	afterelection	successor
NER, 1880, who was the electoral winner of the New Zealand by-election	Baguio_Legislative_Constituency	afterelection	monarch
who are the producers of NER-related products	Nokia_Lumia_625	related	manufacturer
who is NER's candidate for the previous generation of kings?	Eden_(New_Zealand_electorate)	candidate	predecessor	honorificprefix
who is NER's namesake loyal to?	Russian_destroyer_Marshal_Shaposhnikov	shipnamesake	allegiance
where does the current incumbent of the title of NER take office?	Ho_Chi_Minh	title	incumbent	office
which party does the person, thing, or thing with the same name as NER belong to?	Yuanmingyuan	shipnamesake	party
NER what is the occupation of its creator	bomb	chronology
what time zone is used for the location in the southern part of the NER	2012_AFC_Challenge_Cup_qualification	stadium	south	timezone
what is the previous generation of NER's generals?	Battle_of_Legnano	commander	before
NER, American college basketball season, what is the zoning of the location north of its home	2014–15_Utah_Utes_men's_basketball_team	home	north	subdivisiontype
NER, where did the election winner of the New Zealand by-election in 1880 die	Baguio_Legislative_Constituency	afterelection	placeofdeath
NER's election winner who's successor	Russo-Persian_War_(1722–23)	afterelection	monarch
who is the spouse of the previous generation of the title of NER?	Garbage_Island_(TV_episode)	title	before	spouse
The location of the Wikimedia roster NER The name of the location leader in the east is	Macedonia_national_football_team_results	location	w	e
NER which league does the tenant of its host play in	Tokyo_magnitude_8.0	stadium	tenants	league
what is the division of the southern city of NER?	Pancakes	s	subdivisiontype
who is the successor of the place where NER is held?	2011-12_Lekhwiya_SC_season	stadium	after	after
what is the form of the title of the venue of NER?	Football_at_the_1990_Asian_Games-Men	stadium	title	format
who is the successor of the person, thing, thing with the same name as NER?	Asteroid_1776	shipnamesake	successor
what is the predecessor of the person or thing concerned with the consequences of a battle in China in 617 AD?	Battle_of_Huoyi	result	succession
NER, the US college basketball season, what is the time zone of the location north of its home field	2014–15_Utah_State_Aggies_men's_basketball_team	home	north	timezonedst
who is the successor of the descendants of NER's spouse	Ptolemy_X	spouse	issue	successor
what is the title of NER's election winner	Cape_Verde_Democratic_Movement_Party	afterelection	title
what is the title of the previous generation of the descendants of the Austrian Duchess NER	Viridis_Visconti	issue	before	title
which region type does the location in the northwest of the region to which the NER belongs	Phu_Phan_Mountains	region	northwest	settlementtype
what are the titles of NER's generals?	Battle_of_Durbey	commander	title
who is the predecessor of the previous generation where NER was held?	2016_Chinese_FA_Cup	stadium	before	after
what is the predecessor of the successor of NER's venue	2014_World_Cup_Qualifiers_Asia_Third_Round	stadium	after	before
which president does the NER's election winner serve?	Bosnian_general_election,_2014	afterelection	president
who is the predecessor of NER's election winner?	University_of_Wisconsin_Superior	afterelection	predecessor
where the person or thing with the same name as NER happened	Egyptian_French_flux_(1812)	shipnamesake	place
who is NER's predecessor of the same name	Russian_cruiser_Gerzog_Edinburgski	shipnamesake	successor
what is the type of product or work related to NER	Sony_Xperia_Z2a	related	type
NER's location what area does the location in the northwest belong to?	List_of_Lambda_Chi_Alpha_chapters	location	northwest	subdivisionname
who was the president of NER's previous generation	Pierre_Flimland	before	before	after
where does the source of the NER name belong?	Cezanne_(crater)	eponym	field
A battle during the Mongol invasion of Hungary in the 13th century which religion did the participating nations of NER believe in?	Battle_of_the_Tisza	combatant	religion
NER what is the division of its southern area	Sant_Esteve_de_la_Sarga	s	subdivisiontype
where are the leaders of NER installed?	London_local_elections,_2018	leader	title
which religion does NER's election winner belong to?	United_States_Senate_election_in_North_Carolina,_1998	afterelection	religion
who is the name used to name the person influenced by the NER?	Donne_(crater)	eponym	influenced
what was the previous generation of the leaders of the NER, a monarchy in northern Portugal (January-February 1919)	List_of_monarchs_of_the_Northern_and_Southern_Dynasties	leader	before	issue
which party does the legislature where the NER is held belong to?	Central_European_Time_Zone	venue	legislature	party
who is the leader of the administrative area to which NER belongs?	Governor_of_Genoa	body	leader
what is the zoning of a city in Cage County, Utah, United States, NER, location, northeast, location, northeast, location?	Menton_(Utah)	northeast	southeast	subdivisiontype
what is the title of the location leader in the east of where the NER is held?	2012_AFC_Champions_League_knockout_stage	stadium	east	leadertitle
who is the predecessor of the current incumbent of the title of former general secretary of the Lao People's Revolutionary Party NER?	Jumali_Sayagon	title	incumbent	office
NER, a television series whose title is the leader of the legislature	drug_network	starring
NER, New Zealand Rugby League football player (1995-), where is his birthplace?	Taane_Milne	birthplace	location
who is the predecessor of NER's election winner?	Election_Committee_(Legislative_Council_constituency)_by-election,_2001	afterelection	district
what is the dynasty to which a football team's season NER's position is established?	2010-11_CD_Motagua_season	location	legislature
who is the leader of the parliament in which NER holds a seat	indonesian_militant_democratic_party	seats1title	leader
which religion is the NER event?	upper_germania	event	religion
who is NER's father's successor?	princess_of_qingdu	father	subdivisiontype
what is the rank of NER's election winner?	Guatemalan_general_election,_2011	afterelection	rank
where was the person named NER born	Haldane_(lunar_crater)	eponym	education
who is the mother of the leader of NER	Median_Kingdom	leader	religion
what is the previous generation of NER's election winner?	Italian_general_election,_1874	afterelection	clubs
NER, in 1869, what titles were the leaders elected by the Spanish generals	spanish_national_railway	leader	title
who is the architect of the same name of NER	Osterley_(1780_EIC_ship)	shipnamesake	architect
who leads the administrative area to which NER belongs	Governor_of_Genoa	body	leader
A country dominated by Durbar Khant, located in the region of Hatumo, where the leader against the imperialist NER that existed from 1896 to 1921 was born	Dervish_state	leader	placeofbirth	nationality
what is the parent class of NER's related products	Xbox_(brand)	related	parent
what is the offshoot of the person or thing with the same name as Francia's House Hotel NER?	French_cruiser_Foch	shipnamesake	battles
who is the general who is the actual controller of NER?	Transat_AT	controlledby	commander
what wars happened in the era of named characters named as NER	Empon_Volcano	name	era
who are the children of Wallner's election winner?	Democratic_Republican_Party_(South_Korea)	afterelection	children
where is the birthplace of the person whose name is in NER	Selangor_State_Honors_and_Awards_System	name	origin
who is the president of NER's team?	Red_Bull_RB12	team	owner
which sea area does NER's name belong to?	USS_Tutuila_(ARG-4)	shipnamesake	archipelago
which dynasty the person or thing related to the consequences of NER belongs to	Battle_of_Tanshebrai	result	house
what is the honorific prefix for NER generals?	Battle_of_Varese	commander	honorificprefix
where are the people, things and things with the same name as NER	USS_Tutuila_(ARG-4)	shipnamesake	location
what party does the leader of NER belong to?	Provisional_People's_Committee_for_North_Korea	leader	party
who is the king of NER's election winner	Romanian_National_Liberal_Party	afterelection	predecessor
what is the title of the leader of the administrative area for which NER is responsible?	Governor_of_Genoa	body	titleleader
who is the sponsor of NER starring	Night_of_Champions_(2012)	sponsor	format
who is the publisher of NER's sponsor?	Armageddon_(2008)	sponsor	publisher
what time zone is the location south of NER in?	Poboleda	s	n
which NER's client belongs to?	Goldstein	client
where does NER's famous work belong to?	Meyer_Amschel_Rothschild	knownfor	region
who is the creator of NER?	It's_a_SpongeBob_Christmas!_albums	chronology	creator
what type of archipelago does NER belong to?	Milos	archipelago	type
who is the successor of NER's general	Battle_of_Long_Point	commander	after
what war did the man in charge of NER fight in?	Transat_AT	controlledby	battles
what race is the person, thing, thing with the same name as NER?	Bu_Bailiu	shipnamesake
And NER where does the person, thing, thing with the same name belong	Carl_Levin	shipnamesake	order
where was the creator of NER born	Can_I_Borrow_a_Dollar%3F	chronology	format
which event determined the birth country of the Croatian footballer NER?	Igor_Cvitanovic	countryofbirth	establishedevent
what type of NER's famous works belong to?	John_Pemberton	knownfor	type
who is the client of the NER Italy?	Royal_Palace_of_Ficuzza	client	mother
what is the name of the place east of the largest city in NER, a federal state in Brazil	Mato_Grosso	largestcity	east
which country is NER's customer from?	elevator	client
who is the coach of NER's team?	Orlando_Magic	coach	college
what labels are there for countries that use NER	Zengvarcony	states	label
what is the fame of the person whose name was used to name NER?	Boltzmann_equation	eponym	knownfor
where did the name NER come from?	Eijkman_(crater)	eponym	deathplace
what school did the singer of the NER song graduate from?	Oriental_Juliet	extra	birthplace
what is the common language used in the relevant area of NER related events?	Kingdom_of_Galicia_and_Lodomeria	event	commonlanguages
where did the voters played by NER come from?	Zhong_Guobin	alongside	educationlevel
what are the descendants of the person or thing with the same name as NER?	Queen_Mary_(UK)	shipnamesake	issue
what is the religion of the same name of NER?	James_Madison	shipnamesake	religion
what is the name of the place in the southwest of the country where NER is located?	Bled_Castle	locationcountry	southwest
which national team is the person in the national football team NER?	Brunei_under-21_football_team	name	nationalteam
where does the leader of NER belong?	United_Kingdom_general_election,_1886_(Ireland)	leader	title
what is the award of the same name of NER?	German_cruiser_Blucher	shipnamesake	awards
what is the headquarters address of the participating countries of the Civil War NER?	Civil_War_in_the_Republic_of_Congo	combatant	headquarters
who is the successor of the person or thing concerned with the consequences of the Battle of NER in 1106 during the invasion of Normandy by Henry I	Battle_of_Tanshebrai	result	succession
who is the successor of NER's client?	Royal_Spring,_Warsaw	client	after
where did NER's namesake graduate from?	French_aircraft_carrier_Joffre	shipnamesake	education
which is the branch of the election winner of the Wall NER?	Thai_general_election,_1996	afterelection	branch
what area does the mayor of NER belong to?	Four-One_Mountain_Cannon	chieftown	subdivisionname
what are the affiliations of NER's alma mater	Evangelical_Witnesses_Association	almamater	affiliations
what are the descendants of NER's descendants?	Leopold_IV_(Anhalt)	issue	issue
what type of creators are NER	They_All_Went_to_Mexico	chronology	genre
what type of country is NER's participating country?	Battle_of_Chiayi	combatant	status
where did NER's namesake die?	President_Ayes	shipnamesake	placeofdeath
what is the common language spoken in the country of birth of the Congolese footballer NER?	Gabriel_Sacuiani	countryofbirth	commonlanguages
what is the origin of the person whose name is used to name NER?	Penticton_(crater)	eponym	south
who is the director of the same name of NER?	Dry_Stantine_Ankiel	shipnamesake	studio
who is the leader of NER's successor?	United_Kingdom_general_election,_1886_(Ireland)	leader	title
1998 single, what is the ex-creator of NER by Shaquille O'Neal, dj Quick, Lord Tariq and Peter Gunz	The_Way_It's_Goin'_Down	chronology	position
what type of school is NER's alma mater?	Gard_Gordon	almamater	type
what are the countries with the same name participating in NER	SAS_Isandlwana_(F146)	shipnamesake	combatant
who is the ruler of the children of the British statesman (1836-1914) NER	Joseph_Chamberlain	children	regent
which province is the client of NER in?	Cikai_Town	client	provinceprovince
who is the successor of NER's related products?	sony_xperia_z3+	related	predecessor
what type of people are in NER	List_of_awards_and_nominations_received_by_Billy_Ray_Cyrus	name	genre
who founded the record company NER belongs to?	Destiny_(Game)	label	founders
what is the predecessor of the leader of NER	spanish_national_railway	leader	before
who does the information about the participating countries of Middle-earth NER come from?	Battle_of_Bangorach	combatant	source
who is the next general of NER?	Battle_of_Legnano	commander	succession
which dynasty did the descendants of NER belong to?	Belengalia_(Castile)	issue	house
who is the current incumbent of the leader of NER?	Community_of_Saint_Anselm	leader	incumbent
who is the author of the singer who participated in NER	5_(album)	extra	studio
who is the Prime Minister of Irish politician NER's father and mother	Frank_Russell,_2nd_Earl_Russell	parents	primeminister
who is the successor of the general of the medieval war NER?	Battle_of_Legnano	commander	successor
who is the predecessor of NER's parents?	Frank_Russell,_2nd_Earl_Russell	parents	predecessor
who is the president of NER's sponsor	Newton_Football_Club	sponsor	owner
NER what caused the events associated with it	List_of_Czech_monarchs	event	result
2013 UEFA Women's Euro 2013 Final Match NER Related Events Tag What	UEFA_Women's_Euro_2013_Final	event	stadium
what time zone does the volleyball player NER's team use?	Herrera	team	timezone
where NER's election winner takes office	Northern_Cyprus_presidential_election,_2015	afterelection	office
who created the work that made American voice actor NER known?	Sarah_Michelle_Jenner	notableworks	creator
who is the founder of the actual controller of NER?	Brownsea_Castle	controlledby	founder
what is the language of the people in NER	List_of_awards_and_nominations_received_by_Craig_David	name	language
what is the profession of the singer who performed for omarion's album NER	Ollusion	extra	occupation
who legislates in the country where NER is located?	Bled_Castle	locationcountry	legislature
what is the religion of Wallner's election winner?	United_States_Senate_election_in_Nebraska,_2002	afterelection	religion
where was the creator of NER born	The_Milt_Jackson_Big_4	chronology	birthplace
where are the descendants of NER buried	Ramiro_I_(Asturias)	issue	burialplace
which institution does NER's alma mater belong to?	He_Chengtian_(architect)	almamater	affiliation
what is the legislature of NER's country of birth	Igor_Cvitanovic	countryofbirth	legislature
what is the identity of NER's namesake	Plymouth_(Montserrat)	shipnamesake	largestcity
In a French state (as of March 2015) which district is the main town of NER	Montreuil	chieftown	arrondissement
where are NER's customers located?	Goldstein	client
what is the name of the election winner for NER	United_Malaysia_National_Organization_leadership_election,_2009	afterelection	primeminister
what war happened in the era of NER's events	Kingdom_of_Galicia_and_Lodomeria	event	era
who is NER's father next?	Heshuo_Hehui_Princess	father	succession
who are the participating teams of the creators of NER?	The_Way_It's_Goin'_Down	chronology	team
where is the address of NER's namesake	Rivoli	shipnamesake	place
NER, the first prime minister of India (1889-1964), whose parents were his successors	Jawaharlal_Nehru	children	parents
what is the title of the NER and its relevant event leader	Kingdom_of_Galicia_and_Lodomeria	event	titleleader
what is the alma mater of someone affected by NER	Alain_Badiou	influenced	almamater
NER what is the legislature of its province	Pyrkakay_mine	state/province	legislature
who did NER's clients influence	Crane_Garden	client	influences
which sponsor of NER belongs to?	2011_Penrith_Panthers_season	sponsor	parent
where is the birthplace of the coach of the Malaysian badminton player NER	Hafez_Hashim	coach	subdivisiontype
who was influenced by the person whose name was used to name NER?	Aryabhata_(crater)	eponym	region
who leads the countries and regions affected by NER	1857_Basilicata_earthquake	countriesaffected	leader
what type of country is the country using NER	Tokelauan	states	status
what is the name of the alma mater of the person named NER?	Nagaoka_(crater)	eponym	almamater
what is the ex of the client of NER Italy	Royal_Palace_of_Ficuzza	client	before
who has appeared on NER's related products (works)	happy_family	related	genre
To whom do NER's sponsors pledge their allegiance	Medal_of_Merit_(USA)	sponsor	allegiance
what is the honorific suffix of NER's generals?	Battle_of_Long_Point	commander	honorificsuffix
what is the industry of NER's sponsor?	Telstra_Phonewords_Stakes	sponsor	industry
what religion is the country of birth of the Algerian footballer NER?	Rhones_Garvay	countryofbirth	religion
To whom did the leader of an ancient Greek city-state NER owe allegiance	ancient_athens	leader	allegiance
who led the participating countries of the NER	grief_night	combatant	leader
which is the branch of NER's parent (mother)	Didit_Hediprasetyo	parents	branch
who are the parents of the American economist NER's parents?	Franklin_Delano_Roosevelt_III	parents	parents
what region does NER's province belong to in the country?	Alderley_Edge_Mines	state/province	region
what religion does NER's father belong to?	Elihia	father	religion
who is NER's father and mother's spouse	Buch	parents	predecessor
what country does NER's name belong to?	French_battleship_Carnot	shipnamesake	country
what is NER's eponymous legislature	Leopoldus_Primus	shipnamesake	succession
what is the part of the archipelago that NER belongs to?	Milos	archipelago	partstype
which event determines the formation of a country using NER?	Zengvarcony	timezonedst
where is the birthplace of NER's election winner	United_Democratic_Party_(Belize)	afterelection	placeofbirth
where is the person or thing with the same name as NER?	flashlight	shipnamesake	title
what time zone is used in the province where NER is located?	Selkirk_mine	state/province	timezone
who is the spouse of the election winner who elected NER?	German_presidential_election,_1994	afterelection	spouse
what is the company type of NER's sponsor?	Vodacom_Cup	sponsor	companytype
what is the next generation of NER's parents	Neleus	parents	children
what wars were there in the era of people who were named NER	Philolaus_(crater)	eponym	era
where did the person named NER die	Lippershey_(crater)	eponym	placeofdeath
what language is used by people, things and things with the same name as NER	Mohawk_Dutch	shipnamesake	languages
what type of products are related to NER?	Kinder_Surprise_Egg	related	type
The fuse created by people, things, and things with the same name as NER	Laika_(1939)	shipnamesake	eventstart
who are the descendants of NER's generals?	The_Battle_of_Dingtao_(Eastern_Han_Dynasty)	commander	issue
who are NER's parents before?	Franklin_Delano_Roosevelt_III	parents	parents
what is the last work of a person or thing with the same name as NER?	Dry_Stantine_Ankiel	shipnamesake	starring
what is the country of the subject of NER?	Harry_Potter_and_the_Goblet_of_Fire	theme	country
what is the name of the country's prime minister of walner's election winner	Peruvian_general_election,_1985	afterelection
who is the ruler of the generals of the medieval war NER	Battle_of_Legnano	commander	regent
what is the religion of the person whose name was used to name the lunar crater NER?	Born_(crater)	eponym	religion
what is the political type of person or thing about the outcome of a battle NER in the American Civil War?	First_Battle_of_Newtonia	result	status
who are the successors of NER's parents?	Franklin_Delano_Roosevelt_III	parents	after
who did NER's namesake influence?	Descartes	shipnamesake	influences
which president does Wallner's election winner serve?	United_States_Senate_election_in_North_Carolina,_1990	afterelection	president
who is the leader of the person or thing with the same name as the 1915 Royal Navy Queen Elizabeth class warship NER	British_Malaya	shipnamesake	leader
NER's election winner whose last term was	Brazilian_presidential_election,_1960	afterelection	timezone1dst
what is the country of the country (city) affected by NER?	1857_Basilicata_earthquake	countriesaffected	country
who is the leader of NER's event	upper_germania	event	leader
where is the southern part of the person or thing with the same name as NER	Suppress_enemy_air_defense_missions	shipnamesake
where was NER's father's birthplace	Dongfu_see_Ciqia	father	workinstitutions
where did NER play die	Gordian_I	alongside	deathplace
what is the country area to which the person, thing, and thing with the same name as NER belong?	Asteroid_286	shipnamesake	city
what are the labels of singers who participated in NER?	Ollusion	extra	label
who did the origin of the NER name affect?	Sherrington_(crater)	eponym	influences
Who's next show for NER's writing	Hiro_Fujiwara	notableworks	studio
what is the name of the prime minister of the country of the leader of NER?	House_of_Assembly_of_Saint_Vincent_and_the_Grenadines	leader	primeminister
what type of company is NER related to	WingNut_Films	related	companytype
which empire does NER's father belong to?	Princess_of_Zhongshan_(Northern_Qi)	father	dynasty
who starred in the theme of the 2016 Universal's Islands of Adventure NER	Hong_Kong_Sheng_Kung_Hui_Diocese_of_Hong_Kong_Island	theme	artist
NER which country is it named after	French_battleship_Danton	shipnamesake	nationality
in which area is the election winner of the NER election in Minnesota?	United_States_presidential_election_in_Minnesota,_1968	afterelection	district
which dynasty does NER-related events belong to?	Gurjara-Pratihara	event	house
what is the previous generation of the children of the British statesman (1836-1914) NER	Joseph_Chamberlain	children	before
what does the creator of NER do?	Lovers_Walk	chronology	occupation
where is the capital (or provincial capital) of the location involved in the NER-related incident	First_Hungarian_Republic	event	capital
what era is the person or thing related to the consequences of NER?	First_Battle_of_Newtonia	result	era
who are the descendants of NER's clients?	Royal_Palace_of_Ficuzza	client	issue
where is NER's namesake buried	USS_Troup_(1812)	shipnamesake	placeofburial
And NER it was made by the person or thing with the same name	Dry_Stantine_Ankiel	shipnamesake	starring
who are the descendants of NER's father	Gyeongjong_Goryeo	father	issue
what region does the mayor of NER belong to in the country?	Liudu_Town	chieftown	arrondissement
what titles do the related products (works) of the TV series NER have	Invincible_intelligence_agent	related	previousshow
what is the administrative region of the archipelago where NER is located?	new_britain_island	archipelago	countryadmindivisions
what is the name of the leader of a person, thing, or thing with the same name as NER?	Plymouth_(Montserrat)	shipnamesake	leadername
which country is the leader of NER from?	National_Convention	leader	nationality
where did the creators of NER originate from?	Chaos_Paradise_(album)	chronology
NER, the fief of the Holy Roman Empire, which region is the event involved in	List_of_Czech_monarchs	event	territory
what is the name of the place in the southwest of the country where the Croatian footballer NER was born?	Igor_Cvitanovic	countryofbirth	southwest
NER who founded its sponsor	Daughter_of_Venice	sponsor	founder
who is the successor of the leader of NER?	Michael_Ellis_(British_politician)	leader	successor
The consequences of a battle in the American Civil War NER related to whom or who legislated	First_Battle_of_Newtonia	result	legislature
where did Wallner's election winners live?	Peruvian_general_election,_1985	afterelection
what is the nationality of the person whose name is used to name the NER?	Mendes_Pinto_(crater)	eponym	nationality
what is the title of the person, thing, thing with the same name as NER?	Greek_Philosophy	shipnamesake	title
who is the successor of Irish politician NER's father (mother)	Frank_Russell,_2nd_Earl_Russell	parents	successor
what is the area to which the site belongs to the south of NER Catalonia, Spain	Bally-Lobrega	s	arrondissement	subdivisiontype
what is the title of the person or thing related to the consequences of fighting NER?	Battle_of_Bedriacum	result	subdivisiontype
where is NER's team	1955–56_Hapoel_Haifa_FC_season	team	other
Whose name is NER's predecessor?	Warren_Hastings_(1802_EIC_ship)	shipnamesake	monarch
who is the father of NER's client	Royal_Spring,_Warsaw	client	father
who is the spouse of the person named NER?	Cori_(lunar_crater)	eponym	spouse
who is the singer who participated in NER's work?	5_(album)	extra	studio
where do the leaders of NER work?	London_local_elections,_2018	leader	title
what titles are people whose names are used to name NERs	Haldane_(lunar_crater)	eponym	title
where is the archipelago of NER?	fairy_shoal	archipelago	location
which teams are NER's coaches participating in?	Brooklyn_Nets	coach	league
what is the previous generation of the coach of the men's National Football Association football team NER representing India?	Indian_national_football_team	coach	clubs
what is the rank of the person or thing with the same name as NER?	German_destroyer_molders	shipnamesake	rank
who is NER's team that directed the work?	Red_Bull_RB12	team	director
who is the leader of the NER to legislate?	Median_Kingdom	leader	successor
WHAT PRODUCTS FROM THE TEAM OF FRENCH MOTOCROSS NER NER	Thomas_Pages	team	founder
which event determines the establishment of the country in which NER is located?	Bled_Castle	locationcountry	establishedevent
what is the nationality of the person whose name is in NER?	List_of_awards_and_nominations_received_by_Craig_David	name	nationality
where is the address of the event involved in NER	Chinese_Empire	event	place
where is the capital (or provincial capital) of the person, thing, and thing with the same name as the Colony-class frigate NER	St._Helena	shipnamesake	issue
what is the common language of the 1915 Royal Navy Queen Elizabeth class battleship NER of the same name	British_Malaya	shipnamesake	commonlanguages
who has the name in NER influenced by?	Empon_Volcano	name	influenced
where are the major events of the NER held?	Queens_Park_Rovers_2010-2011_season	s	team
what is the representative of the country that uses NER, a language of the ancient Korean Baekje Kingdom	Baekje	states	commonlanguages
what is the occupation of the same name of NER?	Type_13_ship_attack_aircraft	shipnamesake	profession
what is the religion of the leaders of NER?	Federal_Republic_of_Indonesia	leader	religion
what is the type of the same name of NER	Kilauea_Volcano	shipnamesake	type
where are people, things and things with the same name as NER buried?	French-Dutch_War	shipnamesake	mother
Whose predecessor did NER play	Decius	alongside	title
who is the star of NER's famous work?	Khalid_Siddiqui	notableworks	extra
where are the birthplaces of those affected by NER	Bernard_Lewis	influenced	birthplace
what city is in the southwest of NER's province	Sakhalin_Region	state/province
who is the artist who posted the theme of NER	Hong_Kong_Sheng_Kung_Hui_Diocese_of_Hong_Kong_Island	theme	artist
who created the products or works related to NER	Supergirl_(TV_series)	related	teleplay
what do the creators of NER do?	Unbreakable_(Janet_Jackson_album)	chronology	profession
what are the types of sponsors for NER	breaking_Bad	sponsor	genre
with a floating nuclear power plant in Russia. NER what field does the person, thing, and thing with the same name belong to?	Mikhail_Vasilievich_Lomonosov	shipnamesake	workplaces
where is the southern part of the province where NER is located?	Sakhalin_Region	state/province
what religion do the descendants of NER believe in?	Jizen_Pema	issue	religion
what dynasty does NER's client belong to?	Royal_Spring,_Warsaw	client	house
what caused the name of the warship NER during World War II	Greek_Post	shipnamesake
in which province is NER's alma mater?	Amy_Tan	almamater	provinceprovince
in which state is NER's alma mater?	Mark_Van_Ameyde	almamater
what dynasty did NER's father belong to?	Princess_Huaining	father	succession
what is the type of person whose name is used to name the NER	Bolsena_Lacus	eponym	type
what tag does Brunei football player NER's national team place on	Charanchan_Said	nationalteam	location
what area does the location in the southeast of NER's home ground belong to?	2015-16_Kentucky_Wildcats_men's_basketball_team	home	southeast	subdivisionname
Taiwanese politician, for which president did the predecessor of the former president of the Republic of China NER's provincial premier serve	Ma_Ying-jeou	premier	before	president
which dynasty belongs to the legislature of the NER's home during the college basketball season?	2015–16_Iona_Gaels_men's_basketball_team	home	legislature	house
where is the place of death of the successor of the descendants of NER?	Mary_of_Hungary,_Queen_of_Naples	issue	after	placeofdeath
what area does the location in the southeast of NER's venue belong to?	2013_Rugby_League_World_Cup	stadium	southeast	subdivisionname
NER which time zone the location northeast of its location belongs to	2015_NCAA_Division_I_Men's_Soccer_Championship	location	southwest
what is the previous generation of the previous generation represented by NER?	Boston	coach	coachteam	location
who is the father of the ruler of the descendants of NER	Albert_I_(Belgium)	issue	regent
what is the type of successor to the creator of NER	Grammy_Nominees	music	genre
what is the area of the location in the south of NER's headquarters address?	Administrative_divisions_of_Colorado	headquarters	south	subdivisionname
what are the titles of the previous generation leaders of the position of the NER of a football team in a season?	2015_Beijing_Guoan_FC_season	location	before	title
what is the name of the leader of the administrative center where NER is located?	NZR_P_class_(1885)	locale	seat
what is the time zone of the location in the south of NER Utah, United States?	Wales_(Utah)	south	northwest	timezonedst
what are the last descendants of the descendants of NER, the Dukes of Parma and Piacenza from 1854 to 1859	Roberto_I_(Parma)	issue	issue	issue
what time zone does the location in the southern part of NER's venue belong to?	Tropical_Storm_Henry_in_2003	venue	south	timezone
A town in Millard County, Utah, United States, the location in the southeast of NER, the location in the north, and which time zone does the location belong to?	Houghton_(Utah)	southeast	north	timezone
NER which district is the city in the west of the city where it is located	2001_Women's_Hockey_World_Cup_Qualifiers	city	w	arrondissement
who is the first king of the title of NER?	Fernando_Roig	title	last	battles
what time zone does the location in the north of NER belong to?	Ewing_Tower_(Utah)	north	southwest	timezonedst
what is the provincial capital of the location in the west of the NER's venue?	Lincoln_County_War	place	seat	subdivisiontype
what is the previous generation of the successor of NER's venue	Thailand_national_football_team_non-international_results	stadium	predecessor	title
do you know who was hit by The name of the ship of NER	Descartes	shipnamesake	influences
who is the customer of the NER label	Permanent_Mission_of_the_People's_Republic_of_China_to_the_United_Nations	label	appointer
what is the title of The NER Related Thing	Invincible_intelligence_agent	controlledby	appointer
who was the NER leader before	spanish_national_railway	leader	before
what is the dynasty of The father of NER	Princess_of_Zhongshan_(Northern_Qi)	father	dynasty
do you know what the agency headed by The head of NER is	United_Kingdom_general_election,_1886_(Ireland)	leader	honorificprefix
what is the successor to The winner of NER	Battle_of_Tanshebrai	result	successor
what is the race of NER's ship name	Bu_Bailiu	shipnamesake
what religion does NER's descendant believe in?	Jizen_Pema	issue	religion
do you know what is the agency headed by NER's ship name	Carl_Levin	shipnamesake	order
who is the wife of NER Timeline	Christmas_Together	chronology	spouse
what dynasty belongs to Events in NER	Gurjara-Pratihara	event	house
who is the predecessor of The Children of the NER	Joseph_Chamberlain	children	predecessor
do you know who is next to The winner of NER	Battle_of_Bedriacum	result	west
do you know what is the organizational model of the municipal management of the events in NER Bavarian?	Karelian_Autonomous_Soviet_Socialist_Republic	event	governmenttype
do you know what awards Next to NER has won	Takashi_Sakai	alongside	clubs
do you know what is the house of The winner of NER	Battle_of_Tanshebrai	result	house
do you know what is the famous work of The name of the ship of NER	Asrock_anti-submarine_missile	shipnamesake	knownfor
what is the battle of Election after NER	South_Korean_presidential_election,_1980	afterelection	battles
do you know what was the last show of The notable works of NER	Hiro_Fujiwara	notableworks	genre
what is the education of NER's ship name?	French_aircraft_carrier_Joffre	shipnamesake	education
do you know what happened in NER's ship's name	British_Malaya	shipnamesake	event
what is the type of manager of NER	Waterstones_11	sponsor	type
who are the generals participating in the NER name	Germanic	name
do you know what is the estate of NER's ship name	Leopoldus_Primus	shipnamesake	succession
do you know who is the partner of NER's ship name	Asteroid_1816	shipnamesake	consort
do you know where is the birthplace of The leader of NER	ancient_athens	leader	birthplace
where is the death place of NER's ship name	President_Ayes	shipnamesake	placeofdeath
do you know what is the nationality of the head of NER	National_Convention	leader	nationality
do you know what timezone the province where NER is located in	Selkirk_mine	state/province	timezone
do you know who is the leader of Election after NER	Romanian_National_Liberal_Party	afterelection	predecessor
who are the founders of Le label de NER	Destiny_(Game)	label	founders
what are the countries of people, things and things with the same name as participating NER	SAS_Isandlwana_(F146)	shipnamesake	combatant
To whom responsible for NER is loyal	Medal_of_Merit_(USA)	sponsor	allegiance
do you know what is the type of The sea around the NER	Milos	archipelago	type
what is the organization run by The Parents of NER	Frank_Russell,_2nd_Earl_Russell	parents	order
What's before The NER Coach	Indian_national_football_team	coach	clubs
what eponymous domain of NER belongs to	Cavendish_Crater	eponym	field
do you know who is the wife of Election after NER	German_presidential_election,_1994	afterelection	spouse
do you know who are the descendants of Client of NER italy?	Royal_Palace_of_Ficuzza	client	issue
do you know what time zone is using NER ship name	Type_05_micro-sound_submachine_gun	shipnamesake	timezone
do you know who is the founder of the The name of the ship of NER	Soviet_Army_Central_Cluster	shipnamesake	founder
in which country is the The name of the ship of NER	French_battleship_Carnot	shipnamesake	country
what is related to NER's ship name	USS_Hopi_(AT-71)	shipnamesake	related
do you know what kind of NER ship name	Henrik_Ibsen	shipnamesake	genre
who is the heir of Next to NER	Decius	alongside	title
who is the heir to NER's parents	Frank_Russell,_2nd_Earl_Russell	parents	successor
do you know where NER customer come from	Goldstein	client
who is the creator of NER's Notable Works	Sarah_Michelle_Jenner	notableworks	creator
do you know what is the specialty of Election after NER	Italian_general_election,_1992	afterelection	profession
what is the profession of The name of the vessel of NER	Type_13_ship_attack_aircraft	shipnamesake	profession
which party is the NER leader	indonesian_militant_democratic_party	seats1title	party
where is the Alma Mater of The Leader of NER	United_Kingdom_general_election,_1886_(Ireland)	leader	title
what is the type of The name of NER	List_of_awards_and_nominations_received_by_Billy_Ray_Cyrus	name	genre
do you know where the headquarters of NER Country participant is located?	Civil_War_in_the_Republic_of_Congo	commander	office
what was the last term of the Country of NER participant?	Irish_Civil_War	result	eventstart
do you know what ethnicity belongs to NER's ship name?	Type_13_ship_attack_aircraft	shipnamesake	nationality
what are the important positions of The name of the ship of NER	Oscar_von_Hindenburg	shipnamesake	office
what state is Election after NER	United_States_Senate_election_in_West_Virginia,_2014	afterelection	state
who is the actor in The Name of NER's Ship	Dry_Stantine_Ankiel	shipnamesake	starring
do you know what is the name of the administrative district of The main city of NER	Four-One_Mountain_Cannon	chieftown	subdivisionname
do you know what is the postalCodeType of the area where NER is used	Jincheng_dialect	states	postalcodetype
who was the last of Parents of NER	Franklin_Delano_Roosevelt_III	parents	before
do you know who is next to the NER coach	Indian_national_football_team	coach	after
do You Know who Is NER's Timeline Wife	Someone_Put_Your_Hand_Out_(Michael_Jackson_song)	chronology	spouse
Did you know that the common languages of NER's country of origin were Congolese?	Gabriel_Sacuiani	countryofbirth	commonlanguages
do you know who the parents of The Children of the NER are	Anwar	parents
what era did the eponym of NER come from	Haldane_(lunar_crater)	eponym	education
do you know what the southwest of NER country is	Bled_Castle	locationcountry	southwest
do you know who the NER timeline was before	The_Way_It's_Goin'_Down	chronology	before
who is the president of Election after NER	United_States_Senate_election_in_North_Carolina,_1990	afterelection	president
do you know what is the honorary suffix of The leader of NER	London_local_elections,_2018	leader	title
do you know what NER's eponymous job is	Cori_(lunar_crater)	eponym	occupation
what is the currency used in Events in NER	Karelian_Autonomous_Soviet_Socialist_Republic	event	currency
where is the province of The name of the ship from NER	Italian_cruiser_Vittorio_Veneto	shipnamesake	provinceprovince
do you know what is west in NER County united kingdom?	Salcombe	shirecounty	west
do you know who the parents of NER's ship name are	HMS_Hecate_(1871)	shipnamesake	parents
do you know which stadium hosts the NER South	Queens_Park_Rovers_2010-2011_season	s	team
who are the descendants of Events in NER	Gurjara-Pratihara	event	issue
what is the final event of NER's name ship	British_Malaya	shipnamesake	eventend
where is the Alma Mater from NER's ship name	Nausitz	shipnamesake	almamater
do you know what the profession of Election is after NER	United_States_Senate_election_in_North_Carolina,_1998	afterelection	occupation
what is the honorary suffix of Generals of the participating NERs	Battle_of_Long_Point	commander	honorificsuffix
what is the era of the NER name	Empon_Volcano	name	era
do you know who NER's Client was before	Royal_Palace_of_Ficuzza	client	before
do you know who will be the next NER's ship's name	Charles_Evans_Hughes	shipnamesake	after
where is the alma mater of Persons Affected by an NER	Alain_Badiou	influenced	almamater
what is the next term of the NER era	United_Netherlands_Sovereign_Duchy	era	after
do you know NER manager business type	Vodacom_Cup	sponsor	companytype
who is the Prime Minister of NER's parents	Frank_Russell,_2nd_Earl_Russell	parents	primeminister
what is the nationality of Election after NER	Civic_Democratic_Party_leadership_election,_1997	afterelection	cityofbirth
what is the rank of people, things and things with the same name as NER?	German_destroyer_molders	shipnamesake	rank
what party belongs to NER's parents	Didit_Hediprasetyo	parents	party
do you know what is the southeast of the largest city in NER	Mato_Grosso	largestcity	southeast
do you know what happened during the NER ship name	French_ironclad_Alma	shipnamesake	partof
do You Know who Is The Mentor Of NER's Notable Works	Khalid_Siddiqui	notableworks	producer
where is the title of The leader of NER	spanish_national_railway	leader	title
where is the location of the NER Client	Goldstein	client
who is the predecessors of Election after NER	Republic_of_China_presidential_election,_1918	afterelection	predecessor
who is the monarch whose leader is The name of the ship of NER	HMCS_Carleton	shipnamesake	monarch
what is the Royal Family of NER Client Italy?	Royal_Palace_of_Ficuzza	client	royalhouse
what is the organizational model of the municipal management of the The name of the ship of NER	HMCS_Sherbrooke	shipnamesake	governmenttype
what is the honorary prefix of Generals of the participating NERs	Battle_of_Varese	commander	honorificprefix
do you know what is establishedEvent in NER country	Bled_Castle	locationcountry	establishedevent
in which country is the Alma mater of NER	Edward_Gallek	almamater	country
do you know which league NER team one season football team will play in?	1923–24_Atromitos_FC_season	team	league
what are the important positions of Election after NER	Northern_Cyprus_presidential_election,_2015	afterelection	office
do you know who is the responsible editor of NER	Armageddon_(2008)	sponsor	publisher
what is the era of The Winner of NER, A Battle of the American Civil War?	First_Battle_of_Newtonia	result	era
what is the profession of NER's name	List_of_awards_and_nominations_received_by_Craig_David	name	profession
From what era did the The leader of NER come	Dervish_state	leader	placeofbirth
who is the creator of The NER Related Thing	Supergirl_(TV_series)	related	teleplay
do you know where the head of NER died?	The_Great_Deed_of_National_Salvation	leader	deathplace
do you know what is establishedEvent in NER Homelands	Igor_Cvitanovic	countryofbirth	establishedevent
do you know where the origin of the name of the NERdied	Lippershey_(crater)	eponym	placeofdeath
what is the house of The descendant of NER	Belengalia_(Castile)	issue	house
what is the time zone used by Northwest of NER	Gremore_De_Toro	nw	timezone
do you know who is the wife of NER's ship name	French_ship_Alexandre_(1857)	shipnamesake	religion
who is the predecessor of Events in NER	Gurjara-Pratihara	event	predecessor
what happened in The Winner of NER, A Battle of the American Civil War?	First_Battle_of_Newtonia	result	event
where is the location of NER's Alma mater	Walter_Owen_Bentley	almamater	location
what is the time zone used by NER ship name	HMCS_Wetaskiwin	shipnamesake	timezone
do you know who is the leader of the The leader of NER	Michael_Ellis_(British_politician)	leader	leader
do you know what religion the person who affects NER believes patriot and republican?	Giuseppe_Garibaldi	influences	religion
what are the children of NER Parents	Neleus	parents	children
what is the type of The province where the NER is located	Temple_Cave_Palace	state/province	type
do you know what the royal family belonged to NER's ship name	Haakon_VI	shipnamesake	royalhouse
who is the president of the head of NER	SummerSlam_(1994)	sponsor	chairman
what is the famous eponymous work of NER	Boltzmann_equation	eponym	knownfor
do you know who is the heir of The leader of NER	University_of_Greenland	leader	successor
do you know who is the father of Events in NER	Gurjara-Pratihara	event	father
do you know who Next to NER is loyal to?	Takashi_Sakai	alongside	alongside
where is the administrative center of NER South	Garrigues_(comarca)	s	subdivisionname
where does the religion of Election after NER come from	United_States_Senate_election_in_Nebraska,_2002	afterelection	religion
do you know who will be the next Customer of NER	Royal_Spring,_Warsaw	client	after
do you know where is the birthplace of NER's ship name	Otto_Hahn_Prize	shipnamesake	birthplace
do you know where is the birthplace of The father of NER	Dongfu_see_Ciqia	father	fatherofwife
do You Know where NER Related Things Come From	Xbox_(brand)	related	parent
what is the type of Theme of NER	Harry_Potter_and_the_Goblet_of_Fire	theme	genre
do you know who is the regent of Les enfants du NER	Joseph_Chamberlain	children	regent
do you know what language is used in NER's ship name	MF_Tysnes	shipnamesake	language
what are the countries of NER's name participating?	Germanic	name
do you know who is the president of Alma mater of NER	Shang_Jin_Fu_Wang	almamater	president
do you know who is the NER Theme Mentor	Hong_Kong_Sheng_Kung_Hui_Diocese_of_Hong_Kong_Island	theme	director
do you know what is the description of the map of NER's ship name	French_ship_Polyphemus_(1815)	shipnamesake	subdivisiontype
do you know what is the title of Nickname of NER	Si_Xi	nickname	title
what is the predecessor of Parents of NER	Jawaharlal_Nehru	children	predecessor
do you know what is the battle of The name of the ship of NER	Russian_destroyer_Marshal_Shaposhnikov	shipnamesake	battles
do you know what is the eponymous type of NER	Bolsena_Lacus	eponym	type
what is the type of parts of The sea around the NER	Milos	archipelago	type
who was the person or things that share the same name with NERavant	Cornwallis_Island_(Canada)	shipnamesake	before
who is the cast member of NER's Theme	Hong_Kong_Sheng_Kung_Hui_Diocese_of_Hong_Kong_Island	theme	starring
do you know where is the heir of Generals of the participating NERs	Battle_of_Legnano	commander	succession
do you know where the capital of NER's ship name is	St._Helena	shipnamesake	issue
do you know what is the problem of Generals of the participating NERs	The_Battle_of_Dingtao_(Eastern_Han_Dynasty)	commander	issue
what is the origin of Famous Works of NER	Meyer_Amschel_Rothschild	knownfor	origin
where is the description of The area where NER is used?	Baekje	states	titleleader
What's before Generals of participating NERs	U.S._Southern_Command	commander	awards
who is the predecessor of Beside NER	Zhong_Guobin	alongside	predecessor
do you know who is the mentor of the NER team	Red_Bull_RB12	team	director
what are the important positions of Beside NER	Yong	alongside	office
do you know what is the maker of NER-related things	Nokia_E5-00	related	manufacturer
do you know which national team belongs to NER South	Seattle_University	s
where did Election die after NER	1955_Vietnam_referendum	afterelection	deathplace
who is the source of NER's eponymous information?	Penticton_(crater)	eponym	source
do you know who are the generals involved in the Master of NER	Transat_AT	controlledby	commander
what is the predecessor of The Descendant of NER	Belengalia_(Castile)	issue	predecessor
do you know where is the eponymous title of NER	Haldane_(lunar_crater)	eponym	title
who influenced Client de NER scotland, uk?	Crane_Garden	client	influences
where is the NER Client title	Royal_Spring,_Warsaw	client	title
do you know what is the name of the administrative district of Southern NER	Bally-Lobrega	s	arrondissement
what is the level of management in Northwest of NER spain?	Gurb	nw	subdivisiontype
do you know where is the eponymous address of NER	Cori_(lunar_crater)	eponym	residence
where does the religion of Cities affected by NER come from?	2008_Pakistan_Earthquake	countriesaffected	religion
do you know where the artist who sings for NER is spoken	Languages_of_Papua_New_Guinea	extra	fam
do you know who is next to the NER children	Joseph_Chamberlain	children	after
do you know which domain belongs to The name of the ship from NER	Mikhail_Vasilievich_Lomonosov	shipnamesake	workplaces
what is the name of the administrative division of the province where the NER is located	Khokh-Adar_mine	state/province	subdivisionname
do you know where is the region of The province where the NER is located	Alderley_Edge_Mines	state/province	region
where is the position of the Events in NER	Chinese_Empire	event	place
do you know what religion believes in The main organ of NER chiefs	Governor_of_Genoa	body	religion
do you know what the problem of The Descendant of NER is	Leopold_IV_(Anhalt)	issue	issue
what is the rank of Election after NER?	Guatemalan_general_election,_2011	afterelection	rank
who is the mother of The leader of NER	Median_Kingdom	leader	religion
what religion Does NER come from?	Rhones_Garvay	countryofbirth	religion
do you know what type of settlement is in the province where NER mine in mongolia is located?	Khuut_coal_mine	state/province	west
do you know who is the predecessor of The name of the ship of NER	Asteroid_1895	shipnamesake	after
do you know what the program format of Notable Works of NER is?	Aleks_Krotoski	notableworks	format
what is the birthplace of Generals of participating NERs	Second_Rif_Damascus_Offensive	commander	birthplace
do you know where the birthplace of Persons affected by an NER is?	Bernard_Lewis	influenced	birthplace
what is the honorific suffix of Election after NER	Baguio_Legislative_Constituency	afterelection	honorificsuffix
where is the burial Place of NER's descendant	Ramiro_I_(Asturias)	issue	burialplace
do you know who is the chief of the area where NER is used?	Baekje	states	leader
what is the status of Participating NER Country	Battle_of_Chiayi	combatant	status
do you know what is the source of the Country of NER participant?	Battle_of_Bangorach	combatant	source
who Influenced NER's Ship Name	Henrik_Ibsen	influences	nationality
what is the type of NER addition	I'm_so_sorry	extra	starring
do you know what Election run agency is after NER	German_federal_election,_1920	afterelection	order
do you know which party belongs to NER ship name	Asteroid_1844	shipnamesake	party
do you know who will be the next Election after NER	French_legislative_election,_1893	afterelection	after
who is the architect of the The name of the ship of NER	Osterley_(1780_EIC_ship)	shipnamesake	architect
do you know when the NER Timeline came from	Can_I_Borrow_a_Dollar%3F	chronology	format
do you know what is setEvent to the area where NER is used?	Zengvarcony	states	legislature
do you know where the alma mater of Election is after NER	United_States_Senate_election_in_North_Carolina,_1998	afterelection	almamater
do you know what is the country of NER Client	elevator	client
do you know what is the problem of The winner of NER	Battle_of_Tanshebrai	result	issue
what are the awards won by eponym from NER	Meitner_(Venusian_crater)	eponym	awards
do you know where is the capital of Events in NER	First_Hungarian_Republic	event	capital
where is NER's eponymous birthplace	Hevelius_(crater)	eponym	birthplace
do you know who is the head of the The main organ of the heads of NER	Governor_of_Genoa	body	leader
who is the founder of the Master of NER	Brownsea_Castle	controlledby	founder
what is the label of the area where NER is used?	Zengvarcony	states	label
who is the successor of Generals of the participating NERs	The_Battle_of_Dingtao_(Eastern_Han_Dynasty)	commander	successor
who are the children of the Election after NER	Democratic_Republican_Party_(South_Korea)	afterelection	children
what is the era of the Events in NER	Kingdom_of_Galicia_and_Lodomeria	event	era
do you know what is the name of the administrative district of Northwest of NER	Albucies	nw	subdivisiontype
do you know what the sea is around the NER ship name	USS_Tutuila_(ARG-4)	shipnamesake	archipelago
what is the time zone used by NER South	Poboleda	s	n
do you know who is the creator of NER Timeline	It's_a_SpongeBob_Christmas!_albums	chronology	creator
what is the subdivisionRanks of The name of the vessel of NER	Asteroid_1788	shipnamesake	subdivisionranks
what is the label of L'addition de NER	Ollusion	extra	label
do you know who is the father of NER's ship name	P6M_Sea_Master_Jet_Airship	shipnamesake	father
who is the NER team manager for fall 2016-2017?	1968–69_FDGB_Cup	team	manager
who is Next to NER's Wife	Dong_Biwu	alongside	after
do you know who the successor to The NER Related Thing is	Sony_Xperia_Z2a	related	successor
what is the level of management at NER's vessel name	Scarborough	shipnamesake	subdivisiontype
which party belongs Election after NER	United_States_Senate_election_in_West_Virginia,_2014	afterelection	party
what is the name of the administrative division of The name of the vessel of NER	HMCS_Kamloops	shipnamesake	subdivisionname
do you know what is the region of Famous works of NER	Meyer_Amschel_Rothschild	knownfor	region
what is the house of The father of NER	Princess_Huaining	father	focus
do you know what is the management level of North East of NER World Day Venue	1993_NBA_Playoffs	place	southeast	subdivisiontype
where is the city of The location of The stadium where NER was held	English_Football_League_2006-2007	stadium	before	before
what is the honorific suffix of Occupied people of The title of NER	Wenderson	title	appointer	honorificsuffix
who is the head of the Front of NER location	2015_Beijing_Guoan_FC_season	location	west	leadername
do you know what is the postcode of the south west of NER World Day Location	Seattle_Arctic_drilling_protests	place	south	subdivisionname
what dynasty does The Life of NER World Day Place belong to?	2015–16_FC_Barcelona_Basketball_season	place	legislature	house
what is the level of management in Northeast of NER's title	drug_network	title	southeast	subdivisiontype
what is the time zone used by NER's North of Millionaires	National_Register_of_Historic_Places_listings_in_Davis_County,_Utah	city	north	timezone
what time zone does Northeast of Southeast of NER use?	Schofield_(Utah)	northwest	north	timezonedst
what are the important positions of Name of the leader of The party of NER	Perlis_State_Legislative_Assembly	party	leader1name
do you know who the front of NER's photo caption was before	Boston	coach	coachteam	pagfreevalue
what is the language used in Area covered by the NER location	Beijing-Taiwan_Expressway	location	seat	language
do you know what is the name of administrative district of Capital of NER location	Abu_Simbel_temples	location	capital	subdivisionname
what is the timezone used by Northeast Stadium where NER	1994_Seattle_Seahawks_season	stadium	southeast	timezonedst
do you know what is the management level of The South of NER World Day Venue	2013_ABL_Playoffs	place	northeast	subdivisionname
what dynasty belongs to The Life of NER Site	2015–16_Iona_Gaels_men's_basketball_team	home	legislature	house
do you know what is the name of the administrative district of South East of NER site	2015-16_Kentucky_Wildcats_men's_basketball_team	home	northwest	subdivisionname
do you know what is the management level of Western NER location	Sabah_International_Convention_Centre	location	capital	seats2title
do you know what time zone uses North Western NER the netherlands?	Andel_Poststrasse	west	south	postalcodetype
do you know what is the name of the administrative district of the South of the West of NER	Bicknell_(Utah)	northwest	south	subdivisionname
what is the level of management West of South of NER	Marysville_(Utah)	south	northeast	subdivisiontype
do you know what is the management level of Northern Headquarters of NER	Universities_Canada	headquarters	north	subdivisiontype
what is the name of the administrative division of South of Southeastern NER utah, united states?	Fillmore_(Utah)	southwest	east	subdivisionname
who is the leader of the Northern NER location	Netherlands_at_the_2015_World_Speed_Skating_Championships	location	north	subdivisionname
do you know the language family of the common languages of The stage where the NER took place	1972_African_Cup_of_Nations_qualification	stadium	commonlanguages	fam
who will be the front of the NER location next	Jiangsu_Sainty_Football_Club	location	before	after
what is the name of the administrative division of Le sud de NER, un municipality in baix llobregat, catalonia, spain?	Begues	n	w
what is the house of The father of NER	Zheng_Jian	father	father
do you know what is the name of the administrative district of The Northwest Site of NER	2014–15_Utah_State_Aggies_men's_basketball_team	home	south	subdivisionname
which party belongs to Election after NER	Democratic_Party_(Mongolia)	afterelection	party
who is the father of Regent from The question of NER	Maria_Pia_(Two_Sicilies,_1849-1882)	issue	regent	father
do you know where NER leader died	National_Convention	leader	deathplace
do you know what is the succession of L'avant de La question de NER	Theresa_May	issue	succession
what is the ZIP code for the South West location of NER	2015_Lamar_Hunt_US_Open_Cup	location	east	timezonedst
what is the Typical Settlement of Western NER Region	Central_Luzon	region	northwest	north
do you know what are the subdivision ratings of the NER ship name	An_Zhujun	shipnamesake	subdivisionranks
do you know who is the wife of Election after NER	United_States_presidential_election_in_Wisconsin,_1880	afterelection
do you know where is the title of Election after NER	United_States_Senate_election_in_Georgia,_2014	afterelection	title
what is the name of the administrative division of NER Site West	2014–15_South_Dakota_State_Jackrabbits_men's_basketball_team	home	south	subdivisionname
what is the time zone used by NER Eastern West	Administrative_divisions_of_Ilocos_Sur	east	southwest	north
what is the level of management in the Northwest of the Southwest of NER	Laketown_(Utah)	southwest	north	subdivisiontype
do you know what is the management level of The northeast of NER's place of death	John_James_Joseph_Monaghan	deathplace	northeast	subdivisiontype
who is the head of the Area covered by the The stadium where the NER took place	2014_Malaysia_Premier_League	stadium	seat	leadertitle
do you know what is the name of the administrative district of Eastern Site of NER	2013-14_UC_Santa_Barbara_Gauchos_men's_basketball_team	home	south	subdivisionname
do you know who is next to the Generals of the participating NERs	Battle_of_Long_Point	commander	after
do you know which national team belongs to The coach of NER's club	UEFA_Euro_2016_squads	club	coach	clubs
What's wrong with The Father of NER	Princess_Hongnong	father	issue
what is the birthplace of The Father of NER	Dongfu_see_Ciqia	father	workinstitutions
do you know who was the forward of The NER location before?	Shanghai_Greenland_Shenhua_Football_Club	location	before	before
where is the title of Election after NER	United_States_Senate_election_in_South_Dakota,_2014	afterelection	title
what are the important positions of NER's ship name, un barku den noruega?	Borrell-Carratheodori_theory	shipnamesake	office
what time zone does Northeast of The stadium where the NER took place	2008_Seattle_Seahawks_season	stadium	south	timezone
do you know what is the name of administrative district of Western NER location	Maritimo_Athletic_Association	location	w	subdivisionname
do you know what country the NER location photo caption is	2016–17_Huddersfield_Town_AFC_season	location	establishedevent
do you know what type of The thing related to NER	Sony_Xperia_Z2a	related	type
where is the position of the Vessel name of NER	Italian_battleship_Vittorio_Veneto	shipnamesake	place
where is the city of The location of The stadium where the NER took place	New_Zealand_at_the_Rugby_World_Cup	stadium	before	tenants
do you know where is the city of The operator of The stadium where the NER took place	Asteroid_5109	stadium	tenants	ground
who will be Election after NER next	Bulgarian_election_election,_1986	afterelection	after
do you know what time zone is West of The place of death of NER	Hans-Ulrich_Rudel	deathplace	event
do you know who is the wife of Election after NER	Democratic_Republican_Party_(South_Korea)	afterelection	spouse
do you know what timezone the Northeast of The stadium where NER took place	2013_Seattle_Seahawks_season	stadium	south	timezone
who is the predecessors of The leader of NER	Mongolian_legislative_election,_2016	leader	predecessor
do you know what is the management level of Area covered by the NER location	Asteroid_295	location	seat	subdivisiontype
What's before Generals of participating NERs	Boundary_River_Battle_(Anti-Japanese_War)	commander	before
do you know what time zone uses The province where the NER is located	Hund	state/province	timezone
what is the name of the administrative division of the southwest of NER's location	2011–12_AZ_Alkmaar_season	location	northwest	postalcodetype
do you know who was the Front of World NER Day Venue before	2016_CBA_playoffs	place	before	before
do you know what currency is used in NER Location Release Event	2014_Davis_Cup_Americas_Zone_Group_I	venue	currencyunit
what Happened in the Time of NER's Ship's Name	Russian_ship_of_the_line_Gangut_(1825)	shipnamesake	partof
what is the name of the administrative division of Southern Eastern NER utah, united states?	Carnosh_(Utah)	east	northwest	subdivisionname
do you know who is the heir of Occupied people of The title of NER	Margaret_Beckett	title	appointer	successor
what time zone uses North of The place of death of NER	Jordan_Henderson	deathplace	legislature	leader
do you know what time zone uses West of Southwest of NER	Rotterdam	north	southwest	subdivisionname
what is the time zone used by South of Southeastern NER utah, united states?	Fillmore_(Utah)	southeast	west	timezone
what is the name of the administrative division of the southwest of the northwest of NER	Schofield_(Utah)	northwest	southwest	subdivisionname
who is the heir to NER's ship name	Alfa_Nero	shipnamesake	successor
do you know who is the leader of the South of NER site	2014-15_Santa_Clara_Broncos_women's_basketball_team	home	west
what condition is NER's ship name an arleigh burke class destroyer in?	Carl_Levin	shipnamesake	order
what musical instrument did NER's name use	List_of_awards_and_nominations_received_by_Billy_Ray_Cyrus	name	instrument
do you know what is the management level of North of Northwestern NER utah, united states?	Cushelham_(Utah)	northwest	northeast	subdivisiontype
what is the Famous Work of NER Client	Ultramar_Heathfield	client	knownfor
what is the name of the administrative division of The name of the vessel of NER	INS_Kavaratti	shipnamesake	countryadmindivisions
what is the common language of the NER Location Release Event	Eastern_Tepuis	location	establishedevent	commonlanguages
do you know what time zone is in Club in which The stadium where the NER took place is part	2006_UEFA_European_Under-17_Championship	stadium	tenants	league
what is the name of the southwestern administrative division of NER Millionaires	Administrative_divisions_of_Utah	city	northwest	subdivisionname
what is related to NER's ship name, un barku den estadonan uni di merka?	Chilean	shipnamesake	related
do you know where is the province of the southwestern Administration of NER	Ekkalak_Thongmak	countryadmindivisions	south	postalcodetype
where does the religion of NER's ship name come from?	John_Spaldon_Lewis	shipnamesake	religion
do you know where is the title of The name of the ship of NER	Cornwallis_Island_(Canada)	shipnamesake	title
do you know who is the predecessor of The busy people of The title of NER	Soong_Ching_Ling	title	predecessor
do you know who is the leader of the NER's ship name	Machin_McGill	shipnamesake	leadername
who is the manager of Tenants of The stadium where the NER took place for the fall of 2016-2017?	2012_Montedio_Yamagata_season	stadium	tenants	manager
what is the level of management at the South of The stadium where the NER took place	Heartbreak_Hotel_(Whitney_Houston_song)	stadium	southeast
do you know who was the people, things and things with the same name as NER before	Spanish_cruiser_Don_Antonio_de_Ulloa	shipnamesake	before
do you know where the birthplace of NER's Coach is?	Hafez_Hashim	coach	subdivisiontype
do you know who is the predecessor of The name of the ship of NER	Asteroid_1837	shipnamesake	predecessor
what is the education level of The addition of NER	That_winter,_the_wind_blows	extra	educationlevel
do you know who is the Premier agent of NER Predecessor	You_Xikun	premier	deputy	president
do you know what is the name of the administrative district of the south of the south-west of NER	Clarkston_(Utah)	southwest	south	subdivisionname
do you know what is the management level of Southern Place of NER	Tropical_Storm_Henry_in_2003	venue	northeast
do you know where is the birthplace of the city of Captain of The club of NER	2005_FIFA_World_Youth_Championship_squads	club	before	name
do you know who was the Your next club L'avant de NER before?	Yvonne_Delbos	before	after	before
what is the royal family of The name of the ship of NER	SS_Prinses_Astrid	shipnamesake	royalhouse
what is the national team of The coach of The club of NER	2015_FIFA_U-17_World_Cup_squads	club	coach	clubs
who are the children of NER's name	Chinese_popular	name	children
who is the mother of Your next club The question of NER	Juan_Carlos_I	issue	after	mother
do you know who is the predecessor of Election after NER	Italian_general_election,_1992	afterelection	predecessor
do you know who is the leader of the Publication event of NER location	2012-13_in_Argentina_football	location	establishedevent	leader
do you know what is the occupation of Chronology of NER	Themes_from_Calmi_Cuori_Appassionati	chronology	profession
do You Know which Party Belongs to NER's Location Life	Polonia_(train)	operator	owner	previous
who was the person or things that share the same name with NERavant	detachment	shipnamesake	before
do you know what is the management level of The Northeast Site of NER	2016-17_Idaho_Vandals_men's_basketball_team	home	north	subdivisiontype
do you know what are the subdivision ratings of the NER ship name	HMS_Falcon_(1820)	shipnamesake	subdivisionranks
do you know what state is East of NER location	Tin_Shui_Wai_Pegasus_Football_Club	location	east	state
do you know who is the predecessor of Your next club L'avant de NER	Yvonne_Delbos	before	after	predecessor
do you know what is the management level of The South of NER location	List_of_Cultural_Properties_of_the_Philippines_in_Calabarzon	location	south	subdivisiontype
who is the leader of the Northeast NER location	Tin_Shui_Wai_Pegasus_2010-2011_season	location	west
what is the title of The Descendant of NER	Jizen_Pema	issue	title
do you know what is the management level of The Northeast of NER Millionaires	National_Register_of_Historic_Places_listings_in_Los_Angeles_County,_California	city	northeast	subdivisiontype
which party belongs to Election after NER	National_Liberation_Party	afterelection	party
who is the leader of the East of The stadium where the NER took place	2013_AFC_Champions_League_knockout_stage	stadium	before	stateparty
do you know where the constituency of the West of NER's place of death is	Blank	deathplace	northwest	east
In what condition is NER's Alma mater	Peter_Bramley_(biochemist)	almamater	state
do you know where the Northeast of NER's location is	South_China_Sea	location	northwest
do you know where is the constituency of the North of NER location	Portsmouth_2011-2012_season	location	west
where is the city of The operator of The stadium where the NER took place	2008–09_Coventry_City_FC_season	stadium	establishedevent	locale
do you know what is the management level of NER south	Garrigues_(comarca)	s	subdivisiontype
what is the level of management in Area covered by NER Region	Revolutionary_Party_of_Tanzania	area	seat	subdivisiontype
do you know where is the city of Alma mater de NER	Alexander_Garcia_Padilla	almamater	city
do you know what is the name of the administrative district of Nord-Ouest de NER Belgium?	Pepingen	nw	n
do you know what important positions Election has after NER	Lithuanian_election_election,_2000	afterelection	office
what is the level of management at Southwest NER South utah, united states?	Marysville_(Utah)	south	northeast	subdivisiontype
what is the next term of the NER national team club	Sebastian_Meyer	nationalteam	club	after
who are the parents of NER's ship name	John_F._Kennedy_University	shipnamesake	parents
what is the western national team location of NER	Peng_Zijian	nationalteam	location	east
do you know who is the mentor of the NER addition	5_(album)	extra	studio
do you know what is the management level of NER ship name	Type_05_micro-sound_submachine_gun	shipnamesake	subdivisiontype
do you know what time zone Southwest of North NER utah, united states uses?	Goshen_(Utah)	north	southeast	timezonedst
who is the heir of Election after NER	Iranian_legislative_election,_1956	afterelection	successor
where is the address of the NER team	Hungarian_Football_Second_Division	team	ground
do you know who is the leader of the NER's ship name	Russian_submarine_Severodvinsk_(K-329)	shipnamesake	leadername
do you know where the constituency of the West Venue of NER is?	1993_Women's_Cricket_World_Cup	venue	northwest	constituencywestminster
do you know what timezone uses Southwest from NER West	Roja_(Utah)	north	timezone
what is the NER Location Release Event	2015_LA_Galaxy_season	location	establishedevent	legislature
do you know what kind of NER addition	I'm_so_sorry	extra	starring
what is the ideology of NER's ship name	Soviet_Army_Central_Cluster	shipnamesake	ideology
what is the level of management West of NER's place of death	Medal_of_Honor:_Frontline	deathplace	northeast	subdivisiontype
do you know what is the name of the administrative district of NER Millionaires South united states?	long-range_anti-ship_missile	usedby	commander	birthplace
do You Know where Your Next Club from The NER Question Died	Blanche_of_Namur	issue	regent	placeofdeath
what language does NER addition	That_winter,_the_wind_blows	extra	language
do you know what time zone uses NER South	Province_of_Girona	s	timezone
what musical instrument did NER use?	Heart_&_Soul_(Ron_Carter_and_Cedar_Walton_album)	chronology	instrument
do you know what is the program format of The title of NER World Day Venue?	2016_CBA_playoffs	place	title	format
what is the type of division of The North of City of birth of NER	Robino	position	after	other
do you know who was touched by NER's eponymous	Mach_(crater)	eponym	workplaces
what is the name of the administrative division of the North of The stadium where the NER took place	2013_St_Helens_season	stadium	south	northwest
what is the name of the administrative division of Eastern NER Millionaires	National_Register_of_Historic_Places_listings_in_Wasatch_County,_Utah	city	west	subdivisionname
where is the title of Your next club The question of NER	Mary_of_Hungary,_Queen_of_Naples	issue	title	place
do you know what is the name of administrative district of West of NER site	2014–15_Utah_State_Aggies_men's_basketball_team	home	south	subdivisionname
what is the name of the administrative division of the southwest of The stadium where the NER took place?	Al_Ain_Football_Club	stadium	southwest	subdivisionname
do you know who is the president of the Tenants of The stadium where the NER took place	2011_Emperor's_Cup	stadium	tenants	chairman
do you know what is the name of the administrative district of the south-west of The stadium where the NER took place	2011-12_in_French_football	stadium	northwest
what is the type of The name of NER	List_of_awards_and_nominations_received_by_Lorde	name
who is the president of Alma mater de NER	Deng_Jianhong	almamater	president
do you know what is the management level of Western NER Millionaires	CBU-FM	city	northeast	title
do you know what is the common language of the NER Location Release Event	Colombia_national_football_team_results_(2000–19)	location	establishedevent	commonlanguages
do you know what is the name of the administrative district of The Northwest of NER Millionaires	National_Register_of_Historic_Places_listings_in_King_County,_Washington	city	northwest	subdivisionname
who is the wife of The next term of The question of NER	Charles_Louis,_Hereditary_Prince_of_Baden	issue	next	spouse
do you know what time zone uses Club in which NER location is part?	2011-12_Lleida_Sports_season	location	w	s
do you know who is the predecessor of The name of the ship of NER	French_cruiser_Georges_Leygues	shipnamesake	predecessor
do you know who was the Election after NER before	Spanish_general_election,_1931	afterelection	before
who is the heir to NER's ship name	Egyptian_Pound	shipnamesake	successor
what is the northeast location of NER's national team	Lin_Xiaocheng	nationalteam	location	northeast
do you know what is the traditional shape of the forward of NER's club?	2016_AFC_U-23_Championship_squads	club	before	name
who is the leader of the East of The stadium where the NER took place?	2002_FIFA_World_Cup_qualification_–_AFC_First_Round	stadium	northwest	leadername
what eponymous domain of NER belongs to	D'Alembert_(crater)	eponym	field
do you know who was the front of NER's location before	Australia_women's_national_soccer_team_results_(2000–09)	location	before	before
where are the heirs of Generals of the participating NERs	Battle_of_Shirateng_River_(938)	commander	subdivisiontype
do you know what is the rank of Next to NER	Takashi_Sakai	alongside	clubs
do you know where is the city of Alma mater from NER	Character_Huss_Wayne	almamater	city
who is the heir to the front of NER's title	complete	title	host	after
do you know who the generals involved in the NER ship name are	French_ironclad_Marengo	shipnamesake	commander
do you know where is the city of Alma mater from NER	Evangelical_Witnesses_Association	almamater	city
what is the time zone used by Eastern of Southern NER	Molenwaard	north	timezone
what is the famous eponymous work of NER	Viviani_(crater)	eponym	knownfor
who are the people affected by NER's ship name	CMA_CGM_Alexander_von_Humboldt	shipnamesake	influenced
what are the awards won by The first of The title of NER	John_M_Loh	title	first	awards
what is the traditional shape of the forward of NER's club	2016_AFC_U-23_Championship_squads	club	before	name
what is EstablishedEvent at NER Country	International_Association_of_Inventions'_Unions	locationcountry	establishedevent
do you know what are the subdivision ratings of the NER ship name	Asteroid_1607	shipnamesake	subdivisionranks
who is the leader of the Northwest NER location	2015–16_in_Hong_Kong_football	location	west
do you know where the religion of The name of the ship of NER comes from?	MS_Giulio_Cesare	shipnamesake	religion
do You Know what Language Lyrics Of NER's Title Is Using	The_Beat_Goes_On	title	genre
do you know who is the predecessor of The name of the ship of NER	French_ship_Alexandre_(1857)	shipnamesake	religion
do you know what awards the person or things that share the same name with NER ontario, won?	HMCS_Carleton	shipnamesake	awards
what are the eponymous prizes won by NER	Fermi_(crater)	eponym	awards
what is the next term of the father of NER	Prince_Weicheng	father	after
do you know what is the title of the seats of the location of the National team of NER	Heinrich_Schmidtgar	nationalteam	location	title
who was the Predecessor of L'avant de NER before	Pierre_Flimland	before	before	after
what is the name of the administrative division of Southern NER	Vilallonga_de_Ter	nw	subdivisionname
who is the predecessors of The Parents of NER	Frank_Russell,_2nd_Earl_Russell	parents	predecessor
do you know what is the district of The main city of NER	Catholic_Diocese_of_Kilmore	chieftown
do you know what the profession of NER addition is?	genius_babysitter	extra	occupation
what is the level of management at NER South	la_le_la_de_gaia	s	subdivisiontype
what are the important positions of Beside NER	Zhong_Guobin	alongside	educationlevel
do You Know who Will Be Next The Ahead Of NER's Question	Maria_Beatrix_(Austria-Este)	issue	after	mother
do you know what time zone uses Southeastern NER location a football team season?	2012_Santos_FC_season	location	northwest	leadertitle
where does the religion of Election after NER come from	Labour_Party_(UK)	afterelection	religion
do you know where NER's The Name of the Ship takes place?	Russian_ship_of_the_line_Gangut_(1825)	shipnamesake	place
do you know who is the leader of the Eastern NER location	2014–15_Bengaluru_FC_season	location	west	leadername
what is the name of the administrative division of Southern NER County	List_of_National_Historic_Landmarks_in_Massachusetts	countycounty	west
do you know where is the address of the tenants of the stadium where the NER took place	2015-16_Atlético_Madrid_season	stadium	tenants	ground
do you know what is the specialty of Inaugural speech of The title of NER	Benjan_Wallage	title	appointer	appointer
what are the important positions of Election after NER	United_States_Senate_election_in_North_Carolina,_1998	afterelection	occupation
what is the name of the administrative division of Southern Site of NER	2014-15_Washington_Huskies_women's_basketball_team	home	south	subdivisionname
do you know where the religion of NER's ship's name comes from	French-Dutch_War	shipnamesake	religion
where is the Alma Mater of Election after NER	United_States_Senate_election_in_West_Virginia,_2014	afterelection	almamater
do you know who is the leader of the The North West of The stadium where the NER took place	2013_AFC_Champions_League_group_stage	stadium	before	tenants
do you know where the Northeast of NER site is	2016-17_Houston_Cougars_women's_basketball_team	home	northwest	governmenttype
do you know who is the leader of The life of The stadium where the NER took place	2013-14_NFL_playoffs	stadium	north	postalcodetype
what is the level of management at NER South	Puigros	s	subdivisiontype
what is the common language of the NER Location Release Event	2010-11_CD_Motagua_season	location	establishedevent	commonlanguages
In what state is The name of the ship from NER	Japanese_cruiser_Mogami_(1934)	shipnamesake
where is NER's eponymous death place	Barringer_(lunar_crater)	eponym	placeofdeath
what is the name of the administrative division of Birthplace of L'avant de NER	Karl_Keogh	before	birthplace	subdivisionname
do you know what is the famous work of NER's eponymous	Eijkman_(crater)	eponym	knownfor
do you know what is the name of the administrative district of The Northeast of The stadium where the NER took place	2017_World_Men's_Handball_Championship_–_European_qualification	stadium	southeast	seat
do you know what is the name of the administrative district of Western NER Millionaires	National_Register_of_Historic_Places_listings_in_Cache_County,_Utah	city	northwest	subdivisionname
in which state is the Area covered by the NER location	Shanghai_Greenland_Shenhua_Football_Club	location	seat	state
do you know who is the mother of NER's ship name	French_frigate_Cleopatra_(1781)	shipnamesake	mother
do you know that before the person or thing related to the result caused by NER is?	Battle_of_Huoyi	result	succession
do you know where is the title of Inaugural Speech of The title of NER	Margaret_Beckett	title	appointer	title
do you know who is the head of the The head of the NER	Scottish_Conservative_Party	seats1title	leader
do you know where is the administrative center of the province where the NER is located	Han_Changfu	state/province	seat
do you know what is the title of The winner of NER	Battle_of_Tanshebrai	result	title
what is the time zone used by The North West of the South West of NER	Emory_(Utah)	northwest	north	timezone
what is the level of management at NER's Southeast Site	2011-12_BYU_Cougars_women's_basketball_team	home	north	subdivisiontype
what Happened in the Time of NER's Ship's Name	Rivoli	shipnamesake	partof
what is the Model Regulation of The province where the NER is located	Koksay	state/province	settlementtype
do you know where is the address of The operator of The stadium where the NER took place	2012-13_PAOK_FC_season	stadium	tenants	ground
do you know who is the president of NER's ship name	Asteroid_1895	shipnamesake	after
do you know who is the predecessor of Inaugural speech of The title of NER	Milton_Obote	title	inaugural	after
do you know what time zone is in East of NER location	2010-11_Valencia_CF_season	location	n	timezone1dst
what is the nationality of Election after NER	Brazilian_presidential_election,_1960	afterelection	timezone1dst
what are the products of The owner of NER's club	Softball_at_the_2008_Summer_Olympics	club	manager	team
what is related to responsible for NER	Coca-Cola_Topnotchers	sponsor	related
do you know what is the name of the administrative district of The North of NER Millionaires	National_Register_of_Historic_Places_listings_in_Davis_County,_Utah	city	north	subdivisionname
where is NER's eponymous Alma Mater	Harden_(crater)	eponym	almamater
where is the administrative center of Western NER County	Hurricane_Rita_tornado_outbreak	countycounty	west	seat
who are the descendants of NER's ship name	French_frigate_Cleopatra_(1781)	shipnamesake	issue
do you know who the person or things that share the same name with NER were before?	French_cruiser_Georges_Leygues	shipnamesake	successor
do you know where is the title of Election after NER	Cape_Verde_Democratic_Movement_Party	afterelection	title
where Does the Religion of Inaugural Speech from NER's Title Come From?	Jose_Luis_Rodriguez_Zapatero	title	president	before
which party belongs to The life of The stadium where the NER took place	2010-11_in_Australian_soccer	stadium	timezone1dst
do you know which party belongs to NER ship name	Asteroid_1837	shipnamesake	party
what is the time zone used by the NER Southwest Site	2014-15_BYU_Cougars_men's_basketball_team	home	south	subdivisionname
do you know who was the Election after NER before	French_legislative_election,_1914	afterelection	before
do you know what time zone is in South of NER spain?	Bally-Lobrega	s	arrondissement
To which party belongs The name of the ship of NER	Asteroid_716	shipnamesake	party
do you know what type of zoning is at the National team location of NER	Ragnar_Kravan	nationalteam	location	subdivisiontype
do you know where is the city of The location of Birthplace of NER	Born_to_Run_(Lost)	birthplace	location	city
what is the level of management at West of NER's location	List_of_National_Cultural_Treasures_in_the_Philippines	location	west	subdivisiontype
who are the NER eponymous affected people	Protagoras_(crater)	eponym	influences
what is the name of the administrative division of the Southeast of NER site	2014-15_Gonzaga_Bulldogs_women's_basketball_team	home	south	subdivisionname
do you know what is the name of the administrative district of The Northwest Site of NER	2015-16_Utah_State_Aggies_men's_basketball_team	home	south	subdivisionname
who is the predecessors of The leader of NER	Documentary	leader	predecessor
what is the level of management at Country Capital to which NER belong	Trujillo_State_Anthem	country	northeast
what is the level of management at NER's West of Photo Caption	Tanaecia	imagecaption	northeast
what is the level of management at NER's North West Site	2011-12_UCLA_Bruins_men's_basketball_team	home	northwest	subdivisiontype
