what is the timezong of C's southern regionabanes, Girona?	Cabanes,_Girona
which bay makes the origin of R's nameayleigh (lunar crater) famous?	Rayleigh_(lunar_crater)
what is the program that is before the works that make M knownari Yamazaki?	Mari_Yamazaki
who does the origin of Y's nameoung (crater) influence?	Young_(crater)
who is the producer of P's famous workshilip Eisner?	Philip_Eisner
Savez-vous ce qu’est la dynastie ?	Elisabeth_of_Bavaria,_Queen_of_Belgium
which language does I's famous workssmail Shahid belong to?	Ismail_Shahid
which program is before A's famous worksyame Goriki?	Ayame_Goriki
who is the director of the works that make L knownenore Aubert?	Lenore_Aubert
what is the program that is before A's famous worksyame Goriki?	Ayame_Goriki
who is the predecessor of S-related productsony Xperia E1?	Sony_Xperia_E1
Savez-vous quels sont les pays participants	Heraclea_Lucania
who is the predecessor of S's related productsamsung Galaxy Tab 7.0 Plus?/ who is the father of S's related productsamsung Galaxy Tab 7.0 Plus?	Samsung_Galaxy_Tab_7.0_Plus
what is the deathpalce of the origin of K's namearrer (crater)?	Karrer_(crater)
which type of subdivision does L's southern regionlimiana belong to?	Llimiana
who starred in the works that make N knownirut Sirijanya?	Nirut_Sirijanya
who is the successor of the origin of S's nameputnik Planum?	Sputnik_Planum
which type does S-related productsony Xperia SP belong to?	Sony_Xperia_SP
who is the starring role of O's related productsrange Marmalade?	Orange_Marmalade
who married the person of T-related eventhose Were the Days (song)?	Those_Were_the_Days_(song)
what is the nationality of the origin of A's nameston (crater)?	Aston_(crater)
where does the origin of H's nameippocrates (lunar crater) take place?	Hippocrates_(lunar_crater)
who is the producer of N's famous worksirut Sirijanya?	Nirut_Sirijanya
what is the position of the country related to B-related eventsyzantine Crete?	Byzantine_Crete
which genre does H's famous worksisaya Nakajo belong to?	Hisaya_Nakajo
what is the origin of H's nameaber (crater)?	Haber_(crater)
what is the language of the works that make P knownhilip Eisner?	Philip_Eisner
where is P's famous workshilip Eisner located?	Philip_Eisner
what is connected with X's related productsiaomi Mi 2A?	Xiaomi_Mi_2A
what is the combatant of K related eventsingdom of France (1791–92)?	Kingdom_of_France_(1791–92)
what is the series of I-related productsPhone 6S?	IPhone_6S
who is the founder of P-related productsobeda (watch)?	Pobeda_(watch)
what is the origin of B's namealzac (crater) awarded?	Balzac_(crater)
which field does the origin of M's nameunch (crater) work in?	Munch_(crater)
who starred in N's famous worksirut Sirijanya?	Nirut_Sirijanya
who directed D's famous worksavid White (sound editor)?	David_White_(sound_editor)
who created the works that make E knownric Guggenheim?	Eric_Guggenheim
who is the leader of the 你-held parliament们运动?	你们运动
what is the timezong of M's southern regionontseny?	Montseny
who is the predecessor of the origin of S's namehuckburgh (crater)?/ who is the father of the origin of S's namehuckburgh (crater)?	Shuckburgh_(crater)
who commanded H related eventseraclea Lucania?	Heraclea_Lucania
which party does the 争-held parliament取工作与自由民主论坛 belong to?	争取工作与自由民主论坛
what is the origin of G's namealileo Regio?	Galileo_Regio
what is the language of the works that make A knownl-Nasa'i?	Al-Nasa'i
where is the south of M's southern regiona Tau Kok?	Ma_Tau_Kok
who did a job before N-related productsexus 6P?	Nexus_6P
who is the manufacturer of A's related productstari 8-bit family?	Atari_8-bit_family
who is the predecessor of the origin of A's nameriadaeus (crater)?/ who is the father of the origin of A's nameriadaeus (crater)?	Ariadaeus_(crater)
where is the works that make T knownom Wright (British architect) located?	Tom_Wright_(British_architect)
which title does M-related event related personsecklenburg-Güstrow own?	Mecklenburg-Güstrow
what is the timezong of S's southern regionarroca de Lleida?	Sarroca_de_Lleida
who is the predecessor of M's related productsagic Trackpad?	Magic_Trackpad
which is the captial of the location of U related eventsbangi-Shari?	Ubangi-Shari
who did a job before S-related productsony Xperia Z3 Tablet Compact?	Sony_Xperia_Z3_Tablet_Compact
who is the key people of 2's data source016–17 AFC Wimbledon season?	2016–17_AFC_Wimbledon_season
which genre does O-related productsrange Marmalade belong to?	Orange_Marmalade
which title does the administrative region to which 怀 belongs俄明州州长 belong to?	怀俄明州州长
which type of subdivision does C's southern regionastellfollit del Boix belong to?	Castellfollit_del_Boix
what is the program that is before the works that make A knownyame Goriki?	Ayame_Goriki
where does E related eventsuroBasket 2015 Final occur?	EuroBasket_2015_Final
what is the deathpalce of the origin of T's nameheophrastus (crater)?	Theophrastus_(crater)
what is the warrior of H related eventseraclea Lucania?	Heraclea_Lucania
which industry is P's related productsobeda (watch) from?	Pobeda_(watch)
what does I's famous workssmail Shahid belong to?	Ismail_Shahid
who is the predecessor of S's related productsony Xperia miro?	Sony_Xperia_miro
who is the leader of the 河-held parliament流 (政党)?	河流_(政党)
which religion does the origin of B's nameragg (crater) believe? 	Bragg_(crater)
what is the region of the origin of G's nameassendi (crater)?	Gassendi_(crater)
which type does P-related productsiaggio Ciao belong to?	Piaggio_Ciao
what is children of the person of T related eventhose Were the Days (song)?	Those_Were_the_Days_(song)
who does the origin of X's nameenophon (crater) influence?	Xenophon_(crater)
what is connected with A's related productsrctic Star?	Arctic_Star
what is the nationality of the origin of S's nameommerfeld (crater)?	Sommerfeld_(crater)
where is the alma mater of the origin of A's namegassiz (Martian crater)?	Agassiz_(Martian_crater)
which type of subdivision does L's southern regiona Bisbal del Penedès belong to?	La_Bisbal_del_Penedès
which war is included in the era of the origin of A's namevicenna (crater)?	Avicenna_(crater)
where is T's famous worksom Wright (British architect) located?	Tom_Wright_(British_architect)
which region does the origin of H's nameume (crater) belong to?	Hume_(crater)
who is the leader of the 帕-held parliament爾默聯合黨?	帕爾默聯合黨
what is the program that is after C-related productsheese in the Trap?	Cheese_in_the_Trap
who is the starring role of E's famous worksric Guggenheim?	Eric_Guggenheim
what is the title of the origin of N's nameansen (lunar crater)?	Nansen_(lunar_crater)
what is the format of the origin of D's nameebussy (crater)?	Debussy_(crater)
where does D related eventsuchy of Holstein occur?	Duchy_of_Holstein
who starred in the works that make J knownohn D. Voelker?	John_D._Voelker
what is the program that is after the works that make T knownemari Matsumoto?	Temari_Matsumoto
which timezone does D's southern regioneltebre belong to?	Deltebre
what is the cause of M related eventsanchuria under Qing rule?	Manchuria_under_Qing_rule
what is the combatant of K related eventsingdom of Slavonia?	Kingdom_of_Slavonia
which language is used in O-related productsrange Marmalade?	Orange_Marmalade
who does the origin of V's nameieta (crater) influence?	Vieta_(crater)
who is influenced by the origin of G's nameogol (crater)?	Gogol_(crater)
who is the starring role of C-related productsheese in the Trap?	Cheese_in_the_Trap
what is the program that is before C-related productsheese in the Trap?	Cheese_in_the_Trap
who is the manufacturer of S-related productsamsung Galaxy Tab 7.0 Plus?	Samsung_Galaxy_Tab_7.0_Plus
what is the warrior of S related eventshu (state)?	Shu_(state)
what is the language of K's famous workseith Allan (actor)?	Keith_Allan_(actor)
which series does S's related productsony Xperia Z3 Tablet Compact belong to?	Sony_Xperia_Z3_Tablet_Compact
which program is before D's related productsr. Frost?	Dr._Frost
who is the developer of N-related productsexus 5X?	Nexus_5X
what is the timezong of S's southern regionenterada?	Senterada
which program is before C's related productsheese in the Trap?	Cheese_in_the_Trap
who is the predecessor of the origin of B's nameyron (crater)?/ who is the father of the origin of B's nameyron (crater)?	Byron_(crater)
who is the predecessor of M's related productsicrosoft Lumia 950 XL?	Microsoft_Lumia_950_XL
who commanded K related eventsorea under Yuan rule?	Korea_under_Yuan_rule
who is the predecessor of I's related productsPhone 6S?	IPhone_6S
which field does the origin of F's nameranck (crater) work in?	Franck_(crater)
which series does N's related productsokia 3110 classic belong to?	Nokia_3110_classic
which type of subdivision does P's southern regionuigverd de Lleida belong to?	Puigverd_de_Lleida
who developed P's related productslayStation Vita?	PlayStation_Vita
which language is commonly used in K's related productsurumba Gounder?	Kurumba_Gounder
which religion does the origin of K's nameertész (crater) believe? 	Kertész_(crater)
which party does the 奧-held parliament蘭社會民主黨 belong to?	奧蘭社會民主黨
what is the combatant of X related eventsian (state)?	Xian_(state)
who manufactured S's related productsiri Remote?	Siri_Remote
what is the occupation of the origin of K's nameondratyuk (crater)?	Kondratyuk_(crater)
where did the origin of B's nameeals (crater) die?	Beals_(crater)
what is children of the origin of B's nameyron (crater)?	Byron_(crater)
which program is before C-related productsheese in the Trap?	Cheese_in_the_Trap
what is before the 亚-held parliament美尼亚国民大会?	亚美尼亚国民大会
which party does the 安-held parliament大略進步保守黨 belong to?	安大略進步保守黨
Saviez-vous que la série du produits liés à l'ENTITÉest?	Nexus_5X
what is the program after M's famous worksari Yamazaki?	Mari_Yamazaki
which is the captial of the location of B related eventsyzantine Crete?	Byzantine_Crete
which party does the 共-held parliament和提案 belong to?	共和提案
which event started the country involved in B related eventsyzantine Crete?	Byzantine_Crete
which industry does W-related productsall's (meat) belong to?	Wall's_(meat)
who starred in the works that make P knownhilip Eisner?	Philip_Eisner
what is spoken by the works that make M knownari Yamazaki?	Mari_Yamazaki
what is originated from the person of A related eventncient Corinth?	Ancient_Corinth
what is the type of I's related productsPad Air 2?	IPad_Air_2
what is the party of the 正-held parliament义党 (韩国)?	正义党_(韩国)
where is the birthplace of A-related event related personsncient Corinth?	Ancient_Corinth
which college does the origin of G's nameoddard (crater) study?	Goddard_(crater)
what is the origin of V's nameon Behring (crater)?	Von_Behring_(crater)
where does the origin of S's nametark (crater) live?	Stark_(crater)
where did the origin of S's namehort (crater) die?	Short_(crater)
which type of subdivision does V's southern regionacarisses belong to?	Vacarisses
who is the successor of the origin of N's nameecho (crater)?	Necho_(crater)
which program is before T's famous worksemari Matsumoto?	Temari_Matsumoto
what is the currency of N related eventsorthern Rhodesia?	Northern_Rhodesia
who is the predecessor of the origin of H's nameuggins (lunar crater)?	Huggins_(lunar_crater)
what is the program that is before Y's famous worksumiko Igarashi?	Yumiko_Igarashi
who married the origin of A's nameriadaeus (crater)?	Ariadaeus_(crater)
what is the name of the person who influenced the origin of O's namevid (crater)?	Ovid_(crater)
what is the genre of P's famous worksark Seong-ho (comedian)?	Park_Seong-ho_(comedian)
what is the program that is before D's related productsr. Frost?	Dr._Frost
which type does the origin of P's nameantheon Fossae belong to?	Pantheon_Fossae
what is the program that is after A's famous worksyame Goriki?	Ayame_Goriki
which dynasty is the origin of B's nameeals (crater) born? 	Beals_(crater)
what is the timezong of S's southern regionerinyà?	Serinyà
which program is before the works that make I knownzumi Kazuto?	Izumi_Kazuto
what does D related eventsemocratic Republic of Georgia belong to?	Democratic_Republic_of_Georgia
which bay makes the origin of O's namestwald (crater) famous?	Ostwald_(crater)
what is the genre of the works that make H knownisaya Nakajo?	Hisaya_Nakajo
what is the format of the origin of S's nameputnik Planum?	Sputnik_Planum
who is the predecessor of the origin of S's namehuckburgh (crater)?	Shuckburgh_(crater)
where did the origin of H's nameinshelwood (crater) study?	Hinshelwood_(crater)
where is the origin of N's nameansen (lunar crater) educated?	Nansen_(lunar_crater)
which title does the origin of A's nameiry (lunar crater) own?	Airy_(lunar_crater)
what is the genre of the works that make C knownharles Simonyi?	Charles_Simonyi
what is the type of S-related productsony Xperia Z3 Tablet Compact?	Sony_Xperia_Z3_Tablet_Compact
which event establish the administrative region to which 阿 belongs布哈茲總統?	阿布哈茲總統
what is the type of I's related productsPhone 6S?	IPhone_6S
who is the successor of S's related productsamsung Galaxy Tab 7.0 Plus?	Samsung_Galaxy_Tab_7.0_Plus
who leads the 朝-held parliament鲜社会民主党?	朝鲜社会民主党
who makes the law of the administrative region to which 怀 belongs俄明州州长?	怀俄明州州长
what is the location of the origin of H's nameaystack Catena?	Haystack_Catena
what is the series of M's related productsicrosoft Lumia 640?	Microsoft_Lumia_640
who is the predecessor of N-related productsexus 5X?	Nexus_5X
what lies on the northeast of M's southern regiona Tau Kok?	Ma_Tau_Kok
who manufactured S-related productsony Xperia tipo?	Sony_Xperia_tipo
what includes D related eventsuchy of Mantua?	Duchy_of_Mantua
what causes M related eventsanchuria under Qing rule?	Manchuria_under_Qing_rule
what is the timezong of M's southern regionontbrió del Camp?	Montbrió_del_Camp
which language is used in D's related productsr. Frost?	Dr._Frost
what happened in K related eventsingdom of Bora Bora?	Kingdom_of_Bora_Bora
who is the owner of the sources of 2 related data016–17 AFC Wimbledon season?	2016–17_AFC_Wimbledon_season
which arrondissement does A's southern regionbbeville belong to?	Abbeville
who is the author of the works that make C knownharles Simonyi?	Charles_Simonyi
where is the alma mater of the origin of L's nameaveran (crater)?	Laveran_(crater)
which is the captial of the location of C related eventsrown Colony of Labuan?	Crown_Colony_of_Labuan
which bay makes the origin of B's nameragg (crater) famous?	Bragg_(crater)
what is the program after D-related productsr. Frost?	Dr._Frost
what is the club that 2's head coach006 Santos FC season belongs to?	2006_Santos_FC_season
where does X related eventsian (state) occur?	Xian_(state)
which family does I's related productsPad Air 2 belong to?	IPad_Air_2
who designed H's related productsarbin Z-5?	Harbin_Z-5
which type does F's related productsM Towns belong to?	FM_Towns
which genre does A's famous worksyame Goriki belong to?	Ayame_Goriki
which party does the 帕-held parliament爾默聯合黨 belong to?	帕爾默聯合黨
who leads the 奧-held parliament蘭社會民主黨?	奧蘭社會民主黨
where does the origin of L's nameiouville (crater) live?	Liouville_(crater)
what is the southwest of M's southern regiona Tau Kok?	Ma_Tau_Kok
what causes H related eventsistory of Uganda (1971–79)?	History_of_Uganda_(1971–79)
who is the predecessor of M related eventsecklenburg-Güstrow?/ who is the father of M related eventsecklenburg-Güstrow?	Mecklenburg-Güstrow
which network does the works that make E knownric Guggenheim belong to?	Eric_Guggenheim
what is the type of M's related productsagic Trackpad?	Magic_Trackpad
which genre does the origin of K's namealidasa (crater) belong to?	Kalidasa_(crater)
what is the genre of the origin of O's namevid (crater)?	Ovid_(crater)
what is the program that is before O's related productsrange Marmalade?	Orange_Marmalade
Savez-vous qu'avant produits liés à l'ENTITÉest?	標緻2008
who developed I-related productsPhone 5S?	IPhone_5S
what is the parent moutain of P-related productsiaggio Ciao?	Piaggio_Ciao
what happened in the era of the origin of L's nameeucippus (crater)?	Leucippus_(crater)
who is the predecessor of the origin of N's nameecho (crater)?	Necho_(crater)
what is the legislature of the administrative region to which 肯 belongs塔基州副州长?	肯塔基州副州长
who is influenced by the origin of O's namevid (crater)?	Ovid_(crater)
what preceded the 争-held parliament取工作与自由民主论坛?	争取工作与自由民主论坛
who did a job before the origin of N's nameansen (lunar crater)?	Nansen_(lunar_crater)
which type does P-related productsobeda (watch) belong to?	Pobeda_(watch)
who is the creator of N's famous workseil Buchanan?	Neil_Buchanan
what is the occupation of the origin of K's nameimura (crater)?	Kimura_(crater)
what is the genre of the origin of H's nameemingway (crater)?	Hemingway_(crater)
what does the works that make I knownsmail Shahid belong to?	Ismail_Shahid
where is the birthplace of the origin of B's nameiot (crater)?	Biot_(crater)
what is the nationality of the origin of O's namestwald (crater)?	Ostwald_(crater)
which dynasty is the origin of H's nameartmann (crater) born? 	Hartmann_(crater)
which type does N's related productsexus 6P belong to?	Nexus_6P
what causes H related eventsistory of Portugal (1415–1578)?	History_of_Portugal_(1415–1578)
who is the publisher of the works that make P knownaul Barnett (video game designer)?	Paul_Barnett_(video_game_designer)
what is the program that is after I's famous workszumi Kazuto?	Izumi_Kazuto
who is the architect of the works that make J knownohn Madin?	John_Madin
what is the genre of the origin of P's nameoe (crater)?	Poe_(crater)
what is the ethnicity of the origin of B's nameirkeland (lunar crater)?	Birkeland_(lunar_crater)
which country is 2's season006 Santos FC season born?	2006_Santos_FC_season
what includes K related eventsingdom of France (1791–92)?	Kingdom_of_France_(1791–92)
which program is before M's famous worksari Yamazaki?	Mari_Yamazaki
who is the publisher of J's famous workseff Lemire?	Jeff_Lemire
where does the origin of H's nameippocrates (lunar crater) occur?	Hippocrates_(lunar_crater)
which mountain range does W's related productsall's (meat) belong to?	Wall's_(meat)
who do the job after I-related productsPad Air 2?	IPad_Air_2
who developed P's related productsS/2E?	PS/2E
what is the timezong of E's southern regionls Plans de Sió?	Els_Plans_de_Sió
what is the type of M-related productsicrosoft Lumia 640?	Microsoft_Lumia_640
which timezone does S's southern regionant Celoni belong to?	Sant_Celoni
what is the series of N's related productsokia Asha 303?	Nokia_Asha_303
who is the manufacturer of N-related productsokia C2-02?	Nokia_C2-02
who does the origin of K's namealidasa (crater) influence?	Kalidasa_(crater)
which genre does the origin of H's nameemingway (crater) belong to?	Hemingway_(crater)
which college does the origin of B's nameoyle (crater) study?	Boyle_(crater)
which race does the origin of D's nameelisle (crater) belong to?	Delisle_(crater)
who is the predecessor of S-related productsamsung Galaxy Note 7?/ who is the father of S-related productsamsung Galaxy Note 7?	Samsung_Galaxy_Note_7
who does the origin of D's nameemocritus (crater) influence?	Democritus_(crater)
who did a job before the origin of A's nameriadaeus (crater)?	Ariadaeus_(crater)
who is the developer of N's related productsexus 5X?	Nexus_5X
which country does the origin of A's namevicenna (crater) belong to?	Avicenna_(crater)
produits liés à l'ENTITÉbasé sur ce	侠胆雄狮_(2012年电视剧)
who manufactured M-related productsicrosoft Lumia 950 XL?	Microsoft_Lumia_950_XL
what is the subdivision type of R's southern regionupià?	Rupià
what is the party of the 共-held parliament和提案?	共和提案
which type does the works that make M knownichael L. Kurtz belong to?	Michael_L._Kurtz
who developed G-related productsoogle Glass?	Google_Glass
who is the author of the works that make A knownl-Nasa'i?	Al-Nasa'i
which type does A related eventsrmenian Soviet Socialist Republic belong to?	Armenian_Soviet_Socialist_Republic
which type does W's related productsall's (meat) belong to?	Wall's_(meat)
what is the series of N-related productsokia 6220 Classic?	Nokia_6220_Classic
who is the successor of A-related productstari 8-bit family?	Atari_8-bit_family
who is earlier than I-related productsPhone 6S?	IPhone_6S
which series does N-related productsexus 6P belong to?	Nexus_6P
what is the program that is after D's related productsr. Frost?	Dr._Frost
who is the predecessor of S-related productsamsung Galaxy S4 Active?	Samsung_Galaxy_S4_Active
which timezone does N's southern regionavès, Lleida belong to?	Navès,_Lleida
which label does T's famous worksemari Matsumoto belong to?	Temari_Matsumoto
who does the origin of R's nameenoir (crater) influence?	Renoir_(crater)
which language is commonly used in the area of N related eventsorthern Rhodesia?	Northern_Rhodesia
what is the series of S-related productsamsung Galaxy S4 Active?	Samsung_Galaxy_S4_Active
what is the timezong of P's southern regioninell de Solsonès?	Pinell_de_Solsonès
what is the genre of O-related productsrange Marmalade?	Orange_Marmalade
which language is used in the works that make P knownark Seong-ho (comedian)?	Park_Seong-ho_(comedian)
what is the seat title of the administrative region to which 朝 belongs鲜劳动党全国代表大会?	朝鲜劳动党全国代表大会
who is the successor of S-related productsony Xperia E1?	Sony_Xperia_E1
which type of government does B related eventsyzantine Crete belong to?	Byzantine_Crete
who did a job before L's related productsG G3 Stylus?	LG_G3_Stylus
who is the developer of N-related productsexus 6P?	Nexus_6P
who is the commander of L related eventsater Silla?	Later_Silla
which language does the works that make A knownyame Goriki use?	Ayame_Goriki
who is the successor of S's related productsony Xperia Z3 Tablet Compact?	Sony_Xperia_Z3_Tablet_Compact
who is the spouse of the origin of L's nameu Hsun (crater)?	Lu_Hsun_(crater)
what is the program that is after Y's famous worksumiko Igarashi?	Yumiko_Igarashi
what is the title of the administrative region to which 肯 belongs塔基州副州长?	肯塔基州副州长
who do the job after S's related productsony Xperia SP?	Sony_Xperia_SP
who is the manufacturer of S-related productsony Ericsson Xperia X2?	Sony_Ericsson_Xperia_X2
who is the starring role of N's famous worksirut Sirijanya?	Nirut_Sirijanya
